"county","positive","negative","recovered","total_deaths","number_tested","current_infections","date","population"
"Arkansas",284,4061,259,3,4345,22,2020-09-01,18124
"Ashley",388,4055,365,7,4443,16,2020-09-01,20537
"Baxter",139,2646,113,0,2785,26,2020-09-01,41219
"Benton",5394,57911,5099,54,63305,241,2020-09-01,258980
"Boone",369,6508,259,3,6877,107,2020-09-01,37288
"Bradley",295,3000,250,6,3295,39,2020-09-01,10948
"Calhoun",24,1247,22,0,1271,2,2020-09-01,5202
"Carroll",470,5583,425,7,6053,38,2020-09-01,27887
"Chicot",962,4208,926,11,5170,25,2020-09-01,10826
"Clark",236,4682,203,3,4918,30,2020-09-01,22385
"Clay",182,3000,148,5,3182,29,2020-09-01,15061
"Cleburne",259,4385,233,7,4644,19,2020-09-01,25230
"Cleveland",137,1838,124,4,1975,9,2020-09-01,8226
"Columbia",297,3603,256,15,3900,26,2020-09-01,23892
"Conway",210,4716,183,3,4926,24,2020-09-01,20906
"Craighead",1881,23607,1621,15,25488,245,2020-09-01,105701
"Crawford",931,13708,804,9,14639,118,2020-09-01,62472
"Crittenden",1648,11695,1555,34,13343,59,2020-09-01,49013
"Cross",280,3271,236,5,3551,39,2020-09-01,16998
"Dallas",127,1457,76,2,1584,49,2020-09-01,7432
"Desha",243,2954,213,5,3197,25,2020-09-01,11887
"Drew",305,4546,277,5,4851,23,2020-09-01,18502
"Faulkner",1703,27030,1511,9,28733,183,2020-09-01,122416
"Franklin",168,4092,148,2,4260,18,2020-09-01,17780
"Fulton",71,889,56,0,960,15,2020-09-01,12139
"Garland",1434,21156,1272,29,22590,133,2020-09-01,98298
"Grant",191,3508,165,1,3699,25,2020-09-01,18086
"Greene",635,9511,574,4,10146,57,2020-09-01,44623
"Hempstead",330,3454,307,3,3784,20,2020-09-01,22018
"Hot Spring",1719,8422,1661,21,10141,37,2020-09-01,33520
"Howard",425,3157,388,5,3582,32,2020-09-01,13389
"Independence",770,7829,679,6,8599,85,2020-09-01,37264
"Izard",105,2773,80,0,2878,25,2020-09-01,13559
"Jackson",184,4590,155,1,4774,28,2020-09-01,17225
"Jefferson",2112,21002,1773,50,23114,289,2020-09-01,70424
"Johnson",765,5613,745,4,6378,16,2020-09-01,26291
"Lafayette",70,790,63,2,860,5,2020-09-01,6915
"Lawrence",250,2714,226,10,2964,14,2020-09-01,16669
"Lee",1004,3295,974,11,4299,19,2020-09-01,9398
"Lincoln",1608,5274,1366,13,6882,229,2020-09-01,13695
"Little River",284,1448,253,15,1732,16,2020-09-01,12417
"Logan",365,5283,338,1,5648,26,2020-09-01,21757
"Lonoke",728,12694,623,4,13422,101,2020-09-01,72206
"Madison",296,3380,288,2,3676,6,2020-09-01,16078
"Marion",46,1681,39,0,1727,7,2020-09-01,16438
"Miller",612,5116,566,9,5728,37,2020-09-01,43759
"Mississippi",1352,9417,1242,22,10769,88,2020-09-01,42831
"Monroe",95,1786,87,0,1881,8,2020-09-01,7249
"Montgomery",104,1325,60,3,1429,41,2020-09-01,8993
"Nevada",162,2200,138,12,2362,12,2020-09-01,8440
"Newton",120,1227,94,15,1347,11,2020-09-01,7848
"Ouachita",158,4203,125,4,4361,29,2020-09-01,24106
"Perry",63,2087,59,1,2150,3,2020-09-01,10322
"Phillips",407,5091,371,10,5498,26,2020-09-01,19034
"Pike",177,1743,166,1,1920,10,2020-09-01,10808
"Poinsett",489,5497,386,6,5986,97,2020-09-01,24054
"Polk",225,3113,207,3,3338,15,2020-09-01,20163
"Pope",1776,16090,1611,16,17866,149,2020-09-01,63644
"Prairie",115,1546,113,0,1661,2,2020-09-01,8244
"Pulaski",7121,93926,6391,109,101047,621,2020-09-01,393463
"Randolph",311,3628,287,12,3939,12,2020-09-01,17603
"Saline",1591,20056,1379,13,21647,199,2020-09-01,118009
"Scott",86,1446,83,0,1532,3,2020-09-01,10442
"Searcy",101,1512,48,0,1613,53,2020-09-01,7923
"Sebastian",2900,31744,2612,34,34644,254,2020-09-01,127461
"Sevier",1159,5565,1125,12,6724,22,2020-09-01,17193
"Sharp",149,2813,128,5,2962,16,2020-09-01,17043
"St. Francis",1348,9815,1255,4,11163,89,2020-09-01,26294
"Stone",196,2367,150,3,2563,43,2020-09-01,12446
"Union",692,6973,599,20,7665,73,2020-09-01,39732
"Van Buren",120,2812,86,2,2932,32,2020-09-01,16684
"Washington",6921,58089,6641,68,65010,212,2020-09-01,228529
"White",533,10077,449,11,10610,73,2020-09-01,78804
"Woodruff",27,1318,26,0,1345,1,2020-09-01,6660
"Yell",1166,7571,1110,23,8737,33,2020-09-01,21757
"Arkansas",283,4045,253,3,4328,27,2020-08-31,18124
"Ashley",388,4043,362,7,4431,19,2020-08-31,20537
"Baxter",138,2604,109,0,2742,29,2020-08-31,41219
"Benton",5364,57666,5062,52,63030,250,2020-08-31,258980
"Boone",365,6490,252,3,6855,110,2020-08-31,37288
"Bradley",295,2987,247,5,3282,43,2020-08-31,10948
"Calhoun",24,1245,21,0,1269,3,2020-08-31,5202
"Carroll",469,5568,420,7,6037,42,2020-08-31,27887
"Chicot",962,4204,923,10,5166,29,2020-08-31,10826
"Clark",233,4664,199,3,4897,31,2020-08-31,22385
"Clay",182,2986,147,6,3168,29,2020-08-31,15061
"Cleburne",259,4364,231,7,4623,21,2020-08-31,25230
"Cleveland",136,1833,120,4,1969,12,2020-08-31,8226
"Columbia",295,3592,248,15,3887,32,2020-08-31,23892
"Conway",206,4692,182,3,4898,21,2020-08-31,20906
"Craighead",1869,23493,1592,15,25362,262,2020-08-31,105701
"Crawford",921,13583,786,9,14504,126,2020-08-31,62472
"Crittenden",1643,11661,1542,34,13304,67,2020-08-31,49013
"Cross",279,3258,234,5,3537,40,2020-08-31,16998
"Dallas",127,1451,73,2,1578,52,2020-08-31,7432
"Desha",243,2952,212,5,3195,26,2020-08-31,11887
"Drew",304,4531,276,5,4835,23,2020-08-31,18502
"Faulkner",1693,26882,1494,9,28575,190,2020-08-31,122416
"Franklin",166,4071,147,2,4237,17,2020-08-31,17780
"Fulton",70,884,55,0,954,15,2020-08-31,12139
"Garland",1428,21110,1252,29,22538,147,2020-08-31,98298
"Grant",192,3481,163,1,3673,28,2020-08-31,18086
"Greene",634,9480,566,4,10114,64,2020-08-31,44623
"Hempstead",330,3443,303,3,3773,24,2020-08-31,22018
"Hot Spring",1717,8384,1658,20,10101,39,2020-08-31,33520
"Howard",425,3145,385,5,3570,35,2020-08-31,13389
"Independence",765,7812,666,6,8577,93,2020-08-31,37264
"Izard",102,2760,75,0,2862,27,2020-08-31,13559
"Jackson",183,4583,131,1,4766,51,2020-08-31,17225
"Jefferson",2104,20947,1738,50,23051,316,2020-08-31,70424
"Johnson",765,5600,729,4,6365,32,2020-08-31,26291
"Lafayette",68,789,63,2,857,3,2020-08-31,6915
"Lawrence",249,2699,224,10,2948,15,2020-08-31,16669
"Lee",1003,3290,972,11,4293,20,2020-08-31,9398
"Lincoln",1604,5269,1364,13,6873,227,2020-08-31,13695
"Little River",281,1446,250,14,1727,17,2020-08-31,12417
"Logan",365,5263,335,1,5628,29,2020-08-31,21757
"Lonoke",726,12490,613,4,13216,109,2020-08-31,72206
"Madison",296,3375,288,2,3671,6,2020-08-31,16078
"Marion",45,1664,38,0,1709,7,2020-08-31,16438
"Miller",602,5109,557,8,5711,37,2020-08-31,43759
"Mississippi",1349,9397,1222,21,10746,106,2020-08-31,42831
"Monroe",94,1778,87,0,1872,7,2020-08-31,7249
"Montgomery",101,1259,55,3,1360,43,2020-08-31,8993
"Nevada",162,2191,137,12,2353,13,2020-08-31,8440
"Newton",120,1223,94,15,1343,11,2020-08-31,7848
"Ouachita",158,4190,122,4,4348,32,2020-08-31,24106
"Perry",63,2087,58,1,2150,4,2020-08-31,10322
"Phillips",405,5088,365,9,5493,31,2020-08-31,19034
"Pike",176,1737,163,1,1913,12,2020-08-31,10808
"Poinsett",489,5482,379,6,5971,104,2020-08-31,24054
"Polk",224,3109,205,3,3333,16,2020-08-31,20163
"Pope",1774,15998,1580,16,17772,178,2020-08-31,63644
"Prairie",115,1543,112,0,1658,3,2020-08-31,8244
"Pulaski",7072,93160,6302,106,100232,664,2020-08-31,393463
"Randolph",311,3618,281,12,3929,18,2020-08-31,17603
"Saline",1576,19856,1363,12,21432,201,2020-08-31,118009
"Scott",86,1440,82,0,1526,4,2020-08-31,10442
"Searcy",100,1502,47,0,1602,53,2020-08-31,7923
"Sebastian",2877,31583,2551,33,34460,293,2020-08-31,127461
"Sevier",1157,5559,1115,12,6716,30,2020-08-31,17193
"Sharp",149,2810,126,5,2959,18,2020-08-31,17043
"St. Francis",1345,9804,1250,4,11149,91,2020-08-31,26294
"Stone",193,2362,144,2,2555,47,2020-08-31,12446
"Union",691,6962,588,20,7653,83,2020-08-31,39732
"Van Buren",118,2790,84,2,2908,32,2020-08-31,16684
"Washington",6900,57908,6604,65,64808,231,2020-08-31,228529
"White",528,9944,440,11,10472,77,2020-08-31,78804
"Woodruff",27,1310,26,0,1337,1,2020-08-31,6660
"Yell",1162,7547,1103,23,8709,36,2020-08-31,21757
"Arkansas",282,4016,251,3,4298,28,2020-08-30,18124
"Ashley",388,3983,360,7,4371,21,2020-08-30,20537
"Baxter",137,2575,106,0,2712,31,2020-08-30,41219
"Benton",5334,56686,5038,51,62020,245,2020-08-30,258980
"Boone",356,6320,247,3,6676,106,2020-08-30,37288
"Bradley",289,2932,244,5,3221,40,2020-08-30,10948
"Calhoun",23,1227,21,0,1250,2,2020-08-30,5202
"Carroll",465,5492,411,7,5957,47,2020-08-30,27887
"Chicot",962,4115,919,10,5077,33,2020-08-30,10826
"Clark",229,4630,198,3,4859,28,2020-08-30,22385
"Clay",180,2950,146,6,3130,28,2020-08-30,15061
"Cleburne",258,4315,229,7,4573,22,2020-08-30,25230
"Cleveland",136,1817,121,3,1953,12,2020-08-30,8226
"Columbia",293,3547,247,15,3840,31,2020-08-30,23892
"Conway",202,4639,179,3,4841,20,2020-08-30,20906
"Craighead",1851,23213,1568,15,25064,268,2020-08-30,105701
"Crawford",916,13395,774,9,14311,133,2020-08-30,62472
"Crittenden",1641,11589,1535,34,13230,72,2020-08-30,49013
"Cross",275,3126,233,5,3401,37,2020-08-30,16998
"Dallas",127,1433,70,2,1560,55,2020-08-30,7432
"Desha",239,2905,211,5,3144,23,2020-08-30,11887
"Drew",303,4436,275,4,4739,24,2020-08-30,18502
"Faulkner",1679,26515,1475,8,28194,196,2020-08-30,122416
"Franklin",162,4010,145,2,4172,15,2020-08-30,17780
"Fulton",69,868,52,0,937,17,2020-08-30,12139
"Garland",1407,20859,1240,29,22266,138,2020-08-30,98298
"Grant",192,3430,161,1,3622,30,2020-08-30,18086
"Greene",632,9369,564,4,10001,64,2020-08-30,44623
"Hempstead",330,3414,301,3,3744,26,2020-08-30,22018
"Hot Spring",1717,8299,1656,20,10016,41,2020-08-30,33520
"Howard",423,3132,383,5,3555,35,2020-08-30,13389
"Independence",760,7689,655,6,8449,99,2020-08-30,37264
"Izard",102,2698,72,0,2800,30,2020-08-30,13559
"Jackson",182,4567,126,1,4749,55,2020-08-30,17225
"Jefferson",2091,20701,1721,50,22792,320,2020-08-30,70424
"Johnson",754,5548,720,4,6302,30,2020-08-30,26291
"Lafayette",66,786,63,2,852,1,2020-08-30,6915
"Lawrence",248,2655,224,10,2903,14,2020-08-30,16669
"Lee",1002,3267,972,11,4269,19,2020-08-30,9398
"Lincoln",1600,5112,1356,13,6712,231,2020-08-30,13695
"Little River",278,1437,247,14,1715,17,2020-08-30,12417
"Logan",364,5213,330,1,5577,33,2020-08-30,21757
"Lonoke",717,12333,607,4,13050,106,2020-08-30,72206
"Madison",295,3352,287,2,3647,6,2020-08-30,16078
"Marion",44,1640,37,0,1684,7,2020-08-30,16438
"Miller",601,5052,554,7,5653,40,2020-08-30,43759
"Mississippi",1349,9329,1204,21,10678,124,2020-08-30,42831
"Monroe",94,1764,84,0,1858,10,2020-08-30,7249
"Montgomery",96,1241,53,3,1337,40,2020-08-30,8993
"Nevada",162,2181,137,12,2343,13,2020-08-30,8440
"Newton",120,1193,93,15,1313,12,2020-08-30,7848
"Ouachita",157,4112,118,4,4269,35,2020-08-30,24106
"Perry",63,2067,57,1,2130,5,2020-08-30,10322
"Phillips",404,5049,359,9,5453,36,2020-08-30,19034
"Pike",174,1723,159,1,1897,14,2020-08-30,10808
"Poinsett",486,5420,369,6,5906,111,2020-08-30,24054
"Polk",224,3068,195,3,3292,26,2020-08-30,20163
"Pope",1732,15827,1541,14,17559,177,2020-08-30,63644
"Prairie",115,1523,112,0,1638,3,2020-08-30,8244
"Pulaski",7024,92086,6234,105,99110,685,2020-08-30,393463
"Randolph",309,3575,276,12,3884,21,2020-08-30,17603
"Saline",1567,19561,1350,12,21128,205,2020-08-30,118009
"Scott",86,1418,82,0,1504,4,2020-08-30,10442
"Searcy",100,1470,39,0,1570,61,2020-08-30,7923
"Sebastian",2862,31197,2521,33,34059,308,2020-08-30,127461
"Sevier",1157,5518,1105,12,6675,40,2020-08-30,17193
"Sharp",147,2772,126,5,2919,16,2020-08-30,17043
"St. Francis",1344,9102,1246,4,10446,94,2020-08-30,26294
"Stone",194,2340,134,2,2534,58,2020-08-30,12446
"Union",690,6918,584,19,7608,87,2020-08-30,39732
"Van Buren",118,2773,80,2,2891,36,2020-08-30,16684
"Washington",6883,57142,6584,61,64025,238,2020-08-30,228529
"White",524,9725,430,11,10249,83,2020-08-30,78804
"Woodruff",27,1291,26,0,1318,1,2020-08-30,6660
"Yell",1143,7509,1082,23,8652,38,2020-08-30,21757
"Arkansas",277,3958,250,3,4235,24,2020-08-29,18124
"Ashley",388,3972,359,7,4360,22,2020-08-29,20537
"Baxter",132,2527,101,0,2659,31,2020-08-29,41219
"Benton",5313,54264,5025,50,59577,238,2020-08-29,258980
"Boone",316,6033,245,3,6349,68,2020-08-29,37288
"Bradley",289,2916,243,5,3205,41,2020-08-29,10948
"Calhoun",23,1224,21,0,1247,2,2020-08-29,5202
"Carroll",459,5311,405,7,5770,47,2020-08-29,27887
"Chicot",958,4072,916,10,5030,32,2020-08-29,10826
"Clark",226,4459,197,3,4685,26,2020-08-29,22385
"Clay",175,2929,145,6,3104,24,2020-08-29,15061
"Cleburne",256,4262,227,7,4518,22,2020-08-29,25230
"Cleveland",135,1814,121,3,1949,11,2020-08-29,8226
"Columbia",291,3526,247,14,3817,30,2020-08-29,23892
"Conway",201,4592,179,3,4793,19,2020-08-29,20906
"Craighead",1829,23073,1558,15,24902,256,2020-08-29,105701
"Crawford",910,13231,768,8,14141,134,2020-08-29,62472
"Crittenden",1635,11546,1530,33,13181,72,2020-08-29,49013
"Cross",266,3039,230,5,3305,31,2020-08-29,16998
"Dallas",115,1415,68,2,1530,45,2020-08-29,7432
"Desha",237,2892,209,5,3129,23,2020-08-29,11887
"Drew",302,4422,272,4,4724,26,2020-08-29,18502
"Faulkner",1649,26183,1463,8,27832,178,2020-08-29,122416
"Franklin",160,3979,143,2,4139,15,2020-08-29,17780
"Fulton",67,865,52,0,932,15,2020-08-29,12139
"Garland",1400,20782,1229,29,22182,142,2020-08-29,98298
"Grant",183,3399,160,1,3582,22,2020-08-29,18086
"Greene",625,9330,558,4,9955,63,2020-08-29,44623
"Hempstead",329,3406,298,3,3735,28,2020-08-29,22018
"Hot Spring",1713,8275,1650,20,9988,43,2020-08-29,33520
"Howard",421,3123,379,5,3544,37,2020-08-29,13389
"Independence",755,7674,652,5,8429,98,2020-08-29,37264
"Izard",98,2681,71,0,2779,27,2020-08-29,13559
"Jackson",182,4560,125,1,4742,56,2020-08-29,17225
"Jefferson",2082,20586,1711,50,22668,321,2020-08-29,70424
"Johnson",753,5519,719,4,6272,30,2020-08-29,26291
"Lafayette",66,785,63,2,851,1,2020-08-29,6915
"Lawrence",248,2627,223,10,2875,15,2020-08-29,16669
"Lee",1001,3256,970,11,4257,20,2020-08-29,9398
"Lincoln",1570,5107,1352,13,6677,205,2020-08-29,13695
"Little River",276,1429,247,14,1705,15,2020-08-29,12417
"Logan",362,5175,329,1,5537,32,2020-08-29,21757
"Lonoke",705,12207,603,4,12912,98,2020-08-29,72206
"Madison",295,3060,287,2,3355,6,2020-08-29,16078
"Marion",44,1613,36,0,1657,8,2020-08-29,16438
"Miller",599,4837,554,6,5436,39,2020-08-29,43759
"Mississippi",1345,9272,1196,20,10617,129,2020-08-29,42831
"Monroe",92,1755,82,0,1847,10,2020-08-29,7249
"Montgomery",93,1239,52,3,1332,38,2020-08-29,8993
"Nevada",162,2173,137,12,2335,13,2020-08-29,8440
"Newton",117,1150,93,15,1267,9,2020-08-29,7848
"Ouachita",146,4034,117,4,4180,25,2020-08-29,24106
"Perry",62,2056,57,1,2118,4,2020-08-29,10322
"Phillips",397,5021,357,9,5418,31,2020-08-29,19034
"Pike",172,1703,157,1,1875,14,2020-08-29,10808
"Poinsett",478,5377,362,6,5855,110,2020-08-29,24054
"Polk",223,3041,190,3,3264,30,2020-08-29,20163
"Pope",1716,15621,1532,14,17337,170,2020-08-29,63644
"Prairie",114,1519,112,0,1633,2,2020-08-29,8244
"Pulaski",6991,91379,6194,103,98370,694,2020-08-29,393463
"Randolph",308,3566,274,12,3874,22,2020-08-29,17603
"Saline",1547,19406,1338,12,20953,197,2020-08-29,118009
"Scott",86,1409,82,0,1495,4,2020-08-29,10442
"Searcy",95,1436,39,0,1531,56,2020-08-29,7923
"Sebastian",2842,30925,2509,32,33767,301,2020-08-29,127461
"Sevier",1153,5500,1100,12,6653,41,2020-08-29,17193
"Sharp",146,2754,125,5,2900,16,2020-08-29,17043
"St. Francis",1343,9075,1245,4,10418,94,2020-08-29,26294
"Stone",191,2327,130,2,2518,59,2020-08-29,12446
"Union",689,6889,582,20,7578,87,2020-08-29,39732
"Van Buren",116,2754,80,2,2870,34,2020-08-29,16684
"Washington",6850,50862,6576,58,57712,216,2020-08-29,228529
"White",520,9686,423,11,10206,86,2020-08-29,78804
"Woodruff",27,1289,26,0,1316,1,2020-08-29,6660
"Yell",1140,7438,1079,23,8578,38,2020-08-29,21757
"Arkansas",275,3918,246,3,4193,26,2020-08-28,18124
"Ashley",387,3933,357,7,4320,23,2020-08-28,20537
"Baxter",132,2494,98,0,2626,34,2020-08-28,41219
"Benton",5238,53891,4967,48,59129,223,2020-08-28,258980
"Boone",309,5943,240,2,6252,67,2020-08-28,37288
"Bradley",284,2894,238,5,3178,41,2020-08-28,10948
"Calhoun",23,1220,19,0,1243,4,2020-08-28,5202
"Carroll",455,5278,398,7,5733,50,2020-08-28,27887
"Chicot",955,4000,914,10,4955,31,2020-08-28,10826
"Clark",224,4432,196,3,4656,25,2020-08-28,22385
"Clay",172,2903,144,6,3075,22,2020-08-28,15061
"Cleburne",255,4208,225,7,4463,23,2020-08-28,25230
"Cleveland",135,1792,119,3,1927,13,2020-08-28,8226
"Columbia",290,3511,245,14,3801,31,2020-08-28,23892
"Conway",200,4549,178,3,4749,19,2020-08-28,20906
"Craighead",1772,22876,1532,15,24648,225,2020-08-28,105701
"Crawford",896,13114,755,6,14010,135,2020-08-28,62472
"Crittenden",1624,11496,1515,30,13120,79,2020-08-28,49013
"Cross",261,3016,226,5,3277,30,2020-08-28,16998
"Dallas",112,1401,68,2,1513,42,2020-08-28,7432
"Desha",234,2872,206,5,3106,23,2020-08-28,11887
"Drew",298,4393,271,4,4691,23,2020-08-28,18502
"Faulkner",1640,26041,1451,8,27681,181,2020-08-28,122416
"Franklin",158,3936,143,2,4094,13,2020-08-28,17780
"Fulton",66,836,50,0,902,16,2020-08-28,12139
"Garland",1391,20695,1213,28,22086,150,2020-08-28,98298
"Grant",180,3379,157,1,3559,22,2020-08-28,18086
"Greene",615,9279,548,4,9894,63,2020-08-28,44623
"Hempstead",328,3387,291,3,3715,34,2020-08-28,22018
"Hot Spring",1707,8174,1643,20,9881,44,2020-08-28,33520
"Howard",420,3076,374,5,3496,41,2020-08-28,13389
"Independence",751,7388,644,5,8139,102,2020-08-28,37264
"Izard",93,2640,70,0,2733,23,2020-08-28,13559
"Jackson",181,4545,124,1,4726,56,2020-08-28,17225
"Jefferson",2059,20236,1684,50,22295,325,2020-08-28,70424
"Johnson",753,5485,707,4,6238,42,2020-08-28,26291
"Lafayette",66,784,62,2,850,2,2020-08-28,6915
"Lawrence",245,2514,222,10,2759,13,2020-08-28,16669
"Lee",1000,3238,968,10,4238,22,2020-08-28,9398
"Lincoln",1529,5074,1282,13,6603,234,2020-08-28,13695
"Little River",276,1421,243,14,1697,19,2020-08-28,12417
"Logan",360,5138,329,1,5498,30,2020-08-28,21757
"Lonoke",689,12025,593,4,12714,92,2020-08-28,72206
"Madison",290,3054,281,2,3344,7,2020-08-28,16078
"Marion",44,1607,35,0,1651,9,2020-08-28,16438
"Miller",597,4816,553,6,5413,38,2020-08-28,43759
"Mississippi",1325,9120,1179,20,10445,126,2020-08-28,42831
"Monroe",92,1747,81,0,1839,11,2020-08-28,7249
"Montgomery",76,1164,49,3,1240,24,2020-08-28,8993
"Nevada",162,2151,136,12,2313,14,2020-08-28,8440
"Newton",116,1133,92,15,1249,9,2020-08-28,7848
"Ouachita",142,3997,116,4,4139,22,2020-08-28,24106
"Perry",61,2043,57,1,2104,3,2020-08-28,10322
"Phillips",396,4964,353,9,5360,34,2020-08-28,19034
"Pike",170,1688,153,1,1858,16,2020-08-28,10808
"Poinsett",465,5329,354,6,5794,105,2020-08-28,24054
"Polk",220,3005,187,4,3225,29,2020-08-28,20163
"Pope",1699,15491,1508,14,17190,177,2020-08-28,63644
"Prairie",114,1514,112,0,1628,2,2020-08-28,8244
"Pulaski",6928,90501,6120,100,97429,708,2020-08-28,393463
"Randolph",303,3537,268,12,3840,23,2020-08-28,17603
"Saline",1528,19251,1320,11,20779,197,2020-08-28,118009
"Scott",86,1392,81,0,1478,5,2020-08-28,10442
"Searcy",94,1433,39,0,1527,55,2020-08-28,7923
"Sebastian",2817,30680,2473,32,33497,312,2020-08-28,127461
"Sevier",1148,5485,1094,12,6633,42,2020-08-28,17193
"Sharp",149,2694,122,5,2843,22,2020-08-28,17043
"St. Francis",1325,9010,1242,4,10335,79,2020-08-28,26294
"Stone",189,2293,122,2,2482,65,2020-08-28,12446
"Union",683,6732,578,20,7415,85,2020-08-28,39732
"Van Buren",112,2730,74,2,2842,36,2020-08-28,16684
"Washington",6715,50546,6455,56,57261,204,2020-08-28,228529
"White",521,9588,419,10,10109,92,2020-08-28,78804
"Woodruff",27,1287,26,0,1314,1,2020-08-28,6660
"Yell",1136,7376,1076,23,8512,37,2020-08-28,21757
"Arkansas",273,3886,244,2,4159,27,2020-08-27,18124
"Ashley",386,3919,355,7,4305,24,2020-08-27,20537
"Baxter",129,2409,93,0,2538,36,2020-08-27,41219
"Benton",5185,53482,4933,47,58667,205,2020-08-27,258980
"Boone",301,5894,236,1,6195,64,2020-08-27,37288
"Bradley",275,2888,226,5,3163,44,2020-08-27,10948
"Calhoun",23,1218,18,0,1241,5,2020-08-27,5202
"Carroll",448,5244,394,7,5692,47,2020-08-27,27887
"Chicot",948,3992,884,10,4940,54,2020-08-27,10826
"Clark",222,4404,193,3,4626,26,2020-08-27,22385
"Clay",170,2877,144,5,3047,21,2020-08-27,15061
"Cleburne",253,4167,225,6,4420,22,2020-08-27,25230
"Cleveland",134,1786,116,3,1920,15,2020-08-27,8226
"Columbia",288,3433,244,14,3721,30,2020-08-27,23892
"Conway",196,4531,176,3,4727,17,2020-08-27,20906
"Craighead",1746,22437,1504,14,24183,228,2020-08-27,105701
"Crawford",883,12981,735,6,13864,142,2020-08-27,62472
"Crittenden",1619,11315,1496,30,12934,93,2020-08-27,49013
"Cross",258,2986,223,5,3244,30,2020-08-27,16998
"Dallas",109,1396,67,2,1505,40,2020-08-27,7432
"Desha",232,2861,203,5,3093,24,2020-08-27,11887
"Drew",298,4360,269,4,4658,25,2020-08-27,18502
"Faulkner",1610,25826,1445,8,27436,157,2020-08-27,122416
"Franklin",156,3907,141,2,4063,13,2020-08-27,17780
"Fulton",65,816,49,0,881,16,2020-08-27,12139
"Garland",1368,20492,1193,28,21860,147,2020-08-27,98298
"Grant",177,3360,152,1,3537,24,2020-08-27,18086
"Greene",603,9213,543,4,9816,56,2020-08-27,44623
"Hempstead",323,3370,281,3,3693,39,2020-08-27,22018
"Hot Spring",1693,8135,1624,20,9828,49,2020-08-27,33520
"Howard",407,3054,369,5,3461,33,2020-08-27,13389
"Independence",731,7349,633,4,8080,94,2020-08-27,37264
"Izard",88,2614,67,0,2702,21,2020-08-27,13559
"Jackson",180,4391,125,1,4571,54,2020-08-27,17225
"Jefferson",2002,20053,1670,47,22055,285,2020-08-27,70424
"Johnson",749,5428,701,4,6177,44,2020-08-27,26291
"Lafayette",66,772,61,2,838,3,2020-08-27,6915
"Lawrence",245,2448,220,10,2693,15,2020-08-27,16669
"Lee",999,3226,967,10,4225,22,2020-08-27,9398
"Lincoln",1406,5013,1238,13,6419,155,2020-08-27,13695
"Little River",274,1414,231,14,1688,29,2020-08-27,12417
"Logan",359,5111,329,1,5470,29,2020-08-27,21757
"Lonoke",679,11927,586,3,12606,90,2020-08-27,72206
"Madison",287,3037,281,2,3324,4,2020-08-27,16078
"Marion",43,1580,35,0,1623,8,2020-08-27,16438
"Miller",591,4740,543,6,5331,42,2020-08-27,43759
"Mississippi",1304,9042,1161,20,10346,123,2020-08-27,42831
"Monroe",91,1720,78,0,1811,13,2020-08-27,7249
"Montgomery",70,1159,49,3,1229,18,2020-08-27,8993
"Nevada",161,2144,137,11,2305,13,2020-08-27,8440
"Newton",112,1129,92,15,1241,5,2020-08-27,7848
"Ouachita",141,3988,114,4,4129,23,2020-08-27,24106
"Perry",61,2032,57,0,2093,4,2020-08-27,10322
"Phillips",393,4932,344,9,5325,40,2020-08-27,19034
"Pike",167,1685,149,1,1852,17,2020-08-27,10808
"Poinsett",453,5275,349,5,5728,99,2020-08-27,24054
"Polk",218,2990,182,4,3208,32,2020-08-27,20163
"Pope",1658,15376,1483,14,17034,161,2020-08-27,63644
"Prairie",114,1504,112,0,1618,2,2020-08-27,8244
"Pulaski",6855,89446,6067,99,96301,689,2020-08-27,393463
"Randolph",296,3518,256,12,3814,28,2020-08-27,17603
"Saline",1509,18900,1270,11,20409,228,2020-08-27,118009
"Scott",84,1389,79,0,1473,5,2020-08-27,10442
"Searcy",87,1423,36,0,1510,51,2020-08-27,7923
"Sebastian",2790,30421,2439,32,33211,319,2020-08-27,127461
"Sevier",1146,5466,1088,12,6612,46,2020-08-27,17193
"Sharp",147,2683,122,5,2830,20,2020-08-27,17043
"St. Francis",1299,8948,1241,3,10247,55,2020-08-27,26294
"Stone",183,2216,114,2,2399,67,2020-08-27,12446
"Union",670,6728,573,20,7398,77,2020-08-27,39732
"Van Buren",109,2713,73,2,2822,34,2020-08-27,16684
"Washington",6673,50280,6429,55,56953,189,2020-08-27,228529
"White",511,9546,411,10,10057,90,2020-08-27,78804
"Woodruff",27,1284,23,0,1311,4,2020-08-27,6660
"Yell",1133,7337,1069,23,8470,41,2020-08-27,21757
"Arkansas",270,3866,244,2,4136,24,2020-08-26,18124
"Ashley",383,3892,355,7,4275,21,2020-08-26,20537
"Baxter",121,2354,87,0,2475,34,2020-08-26,41219
"Benton",5147,53037,4902,47,58184,198,2020-08-26,258980
"Boone",292,5844,234,1,6136,57,2020-08-26,37288
"Bradley",271,2855,222,5,3126,44,2020-08-26,10948
"Calhoun",23,1209,18,0,1232,5,2020-08-26,5202
"Carroll",442,5222,391,7,5664,44,2020-08-26,27887
"Chicot",943,3986,742,10,4929,191,2020-08-26,10826
"Clark",218,4367,191,3,4585,24,2020-08-26,22385
"Clay",167,2859,141,5,3026,21,2020-08-26,15061
"Cleburne",249,4114,222,6,4363,21,2020-08-26,25230
"Cleveland",132,1775,114,2,1907,16,2020-08-26,8226
"Columbia",286,3419,242,14,3705,30,2020-08-26,23892
"Conway",195,4490,175,3,4685,17,2020-08-26,20906
"Craighead",1728,22257,1483,14,23985,231,2020-08-26,105701
"Crawford",865,12906,721,6,13771,138,2020-08-26,62472
"Crittenden",1602,11267,1488,29,12869,85,2020-08-26,49013
"Cross",248,2958,218,5,3206,25,2020-08-26,16998
"Dallas",104,1363,66,2,1467,36,2020-08-26,7432
"Desha",225,2828,202,5,3053,18,2020-08-26,11887
"Drew",295,4335,253,4,4630,38,2020-08-26,18502
"Faulkner",1593,25489,1429,8,27082,156,2020-08-26,122416
"Franklin",156,3888,139,2,4044,15,2020-08-26,17780
"Fulton",62,796,45,0,858,17,2020-08-26,12139
"Garland",1348,20320,1173,28,21668,147,2020-08-26,98298
"Grant",174,3341,152,1,3515,21,2020-08-26,18086
"Greene",598,9152,535,4,9750,59,2020-08-26,44623
"Hempstead",318,3351,280,3,3669,35,2020-08-26,22018
"Hot Spring",1687,8063,1601,19,9750,67,2020-08-26,33520
"Howard",398,3039,367,5,3437,26,2020-08-26,13389
"Independence",723,7134,625,4,7857,94,2020-08-26,37264
"Izard",83,2584,65,0,2667,18,2020-08-26,13559
"Jackson",175,4379,125,1,4554,49,2020-08-26,17225
"Jefferson",1970,19720,1639,47,21690,284,2020-08-26,70424
"Johnson",745,5405,695,4,6150,46,2020-08-26,26291
"Lafayette",66,771,61,2,837,3,2020-08-26,6915
"Lawrence",244,2424,220,10,2668,14,2020-08-26,16669
"Lee",996,3209,965,10,4205,21,2020-08-26,9398
"Lincoln",1398,4938,1236,13,6336,149,2020-08-26,13695
"Little River",271,1409,222,14,1680,35,2020-08-26,12417
"Logan",355,5089,323,1,5444,31,2020-08-26,21757
"Lonoke",674,11837,575,3,12511,96,2020-08-26,72206
"Madison",287,3028,281,2,3315,4,2020-08-26,16078
"Marion",43,1558,33,0,1601,10,2020-08-26,16438
"Miller",584,4720,537,5,5304,42,2020-08-26,43759
"Mississippi",1292,8985,1143,20,10277,129,2020-08-26,42831
"Monroe",91,1708,74,0,1799,17,2020-08-26,7249
"Montgomery",65,1154,43,3,1219,19,2020-08-26,8993
"Nevada",158,2131,137,11,2289,10,2020-08-26,8440
"Newton",110,1121,92,15,1231,3,2020-08-26,7848
"Ouachita",135,3968,113,4,4103,18,2020-08-26,24106
"Perry",59,2007,56,0,2066,3,2020-08-26,10322
"Phillips",385,4908,338,9,5293,38,2020-08-26,19034
"Pike",163,1676,145,1,1839,17,2020-08-26,10808
"Poinsett",452,5230,342,4,5682,106,2020-08-26,24054
"Polk",212,2968,178,3,3180,31,2020-08-26,20163
"Pope",1620,15269,1452,14,16889,154,2020-08-26,63644
"Prairie",114,1485,110,0,1599,4,2020-08-26,8244
"Pulaski",6761,88327,5995,99,95088,667,2020-08-26,393463
"Randolph",292,3505,250,12,3797,30,2020-08-26,17603
"Saline",1475,18499,1233,11,19974,231,2020-08-26,118009
"Scott",84,1385,79,0,1469,5,2020-08-26,10442
"Searcy",73,1421,34,0,1494,39,2020-08-26,7923
"Sebastian",2753,30141,2396,32,32894,325,2020-08-26,127461
"Sevier",1142,5437,1081,12,6579,49,2020-08-26,17193
"Sharp",145,2660,119,5,2805,21,2020-08-26,17043
"St. Francis",1282,8635,1235,3,9917,44,2020-08-26,26294
"Stone",169,2181,103,1,2350,65,2020-08-26,12446
"Union",653,6710,564,20,7363,69,2020-08-26,39732
"Van Buren",106,2690,67,2,2796,37,2020-08-26,16684
"Washington",6659,49982,6412,55,56641,192,2020-08-26,228529
"White",480,9459,374,10,9939,96,2020-08-26,78804
"Woodruff",27,1268,22,0,1295,5,2020-08-26,6660
"Yell",1118,7277,1068,23,8395,27,2020-08-26,21757
"Arkansas",266,3837,240,2,4103,24,2020-08-25,18124
"Ashley",380,3869,350,7,4249,23,2020-08-25,20537
"Baxter",116,2343,84,0,2459,32,2020-08-25,41219
"Benton",5113,52731,4881,45,57844,187,2020-08-25,258980
"Boone",274,5795,226,1,6069,47,2020-08-25,37288
"Bradley",267,2838,215,5,3105,47,2020-08-25,10948
"Calhoun",23,1205,17,0,1228,6,2020-08-25,5202
"Carroll",437,5204,384,7,5641,46,2020-08-25,27887
"Chicot",939,3976,739,10,4915,190,2020-08-25,10826
"Clark",215,4343,189,3,4558,23,2020-08-25,22385
"Clay",165,2847,138,5,3012,22,2020-08-25,15061
"Cleburne",247,4056,221,6,4303,20,2020-08-25,25230
"Cleveland",130,1762,113,2,1892,15,2020-08-25,8226
"Columbia",284,3403,237,13,3687,34,2020-08-25,23892
"Conway",193,4485,173,3,4678,17,2020-08-25,20906
"Craighead",1701,22068,1470,14,23769,217,2020-08-25,105701
"Crawford",851,12814,712,6,13665,133,2020-08-25,62472
"Crittenden",1595,11187,1470,28,12782,97,2020-08-25,49013
"Cross",244,2945,217,4,3189,23,2020-08-25,16998
"Dallas",103,1290,64,2,1393,37,2020-08-25,7432
"Desha",224,2834,201,5,3058,18,2020-08-25,11887
"Drew",294,4304,250,4,4598,40,2020-08-25,18502
"Faulkner",1579,25431,1410,7,27010,162,2020-08-25,122416
"Franklin",153,3857,138,2,4010,13,2020-08-25,17780
"Fulton",61,787,43,0,848,18,2020-08-25,12139
"Garland",1320,20216,1151,27,21536,142,2020-08-25,98298
"Grant",169,3313,152,0,3482,17,2020-08-25,18086
"Greene",587,9073,522,4,9660,61,2020-08-25,44623
"Hempstead",312,3338,275,3,3650,34,2020-08-25,22018
"Hot Spring",1684,8030,1599,18,9714,67,2020-08-25,33520
"Howard",398,3036,365,5,3434,28,2020-08-25,13389
"Independence",705,7094,614,4,7799,87,2020-08-25,37264
"Izard",80,2574,64,0,2654,16,2020-08-25,13559
"Jackson",175,4366,123,1,4541,51,2020-08-25,17225
"Jefferson",1924,19612,1615,47,21536,262,2020-08-25,70424
"Johnson",742,5358,695,3,6100,44,2020-08-25,26291
"Lafayette",65,770,59,2,835,4,2020-08-25,6915
"Lawrence",245,2403,218,10,2648,17,2020-08-25,16669
"Lee",993,3201,964,10,4194,19,2020-08-25,9398
"Lincoln",1384,4920,1227,13,6304,144,2020-08-25,13695
"Little River",265,1404,215,13,1669,37,2020-08-25,12417
"Logan",351,5057,296,1,5408,54,2020-08-25,21757
"Lonoke",661,11755,559,2,12416,100,2020-08-25,72206
"Madison",287,3024,279,2,3311,6,2020-08-25,16078
"Marion",41,1555,33,0,1596,8,2020-08-25,16438
"Miller",578,4693,532,5,5271,41,2020-08-25,43759
"Mississippi",1277,8944,1119,18,10221,140,2020-08-25,42831
"Monroe",90,1678,74,0,1768,16,2020-08-25,7249
"Montgomery",61,1146,40,3,1207,18,2020-08-25,8993
"Nevada",158,2125,136,11,2283,11,2020-08-25,8440
"Newton",109,1111,90,15,1220,4,2020-08-25,7848
"Ouachita",133,3953,113,4,4086,16,2020-08-25,24106
"Perry",58,2020,56,0,2078,2,2020-08-25,10322
"Phillips",379,4865,335,9,5244,35,2020-08-25,19034
"Pike",161,1670,137,1,1831,23,2020-08-25,10808
"Poinsett",432,5173,333,4,5605,95,2020-08-25,24054
"Polk",208,2954,174,2,3162,32,2020-08-25,20163
"Pope",1605,15190,1417,14,16795,174,2020-08-25,63644
"Prairie",114,1483,108,0,1597,6,2020-08-25,8244
"Pulaski",6675,87572,5931,98,94247,646,2020-08-25,393463
"Randolph",291,3485,243,12,3776,36,2020-08-25,17603
"Saline",1409,18363,1214,10,19772,185,2020-08-25,118009
"Scott",84,1374,78,0,1458,6,2020-08-25,10442
"Searcy",66,1414,32,0,1480,34,2020-08-25,7923
"Sebastian",2722,29904,2371,30,32626,321,2020-08-25,127461
"Sevier",1134,5416,1072,12,6550,50,2020-08-25,17193
"Sharp",137,2645,116,5,2782,16,2020-08-25,17043
"St. Francis",1280,8577,1234,3,9857,43,2020-08-25,26294
"Stone",159,2167,95,1,2326,63,2020-08-25,12446
"Union",650,6578,559,21,7228,70,2020-08-25,39732
"Van Buren",99,2692,62,2,2791,35,2020-08-25,16684
"Washington",6631,49752,6397,55,56383,179,2020-08-25,228529
"White",472,9406,366,9,9878,97,2020-08-25,78804
"Woodruff",27,1264,22,0,1291,5,2020-08-25,6660
"Yell",1113,7235,1066,21,8348,26,2020-08-25,21757
"Arkansas",265,3829,237,2,4094,26,2020-08-24,18124
"Ashley",380,3862,346,7,4242,27,2020-08-24,20537
"Baxter",116,2181,81,0,2297,35,2020-08-24,41219
"Benton",5097,52304,4857,45,57401,195,2020-08-24,258980
"Boone",270,5748,224,1,6018,45,2020-08-24,37288
"Bradley",267,2825,210,5,3092,52,2020-08-24,10948
"Calhoun",23,1203,17,0,1226,6,2020-08-24,5202
"Carroll",436,5169,379,7,5605,50,2020-08-24,27887
"Chicot",939,3972,733,10,4911,196,2020-08-24,10826
"Clark",210,4326,183,3,4536,24,2020-08-24,22385
"Clay",164,2835,136,5,2999,23,2020-08-24,15061
"Cleburne",245,4036,216,6,4281,23,2020-08-24,25230
"Cleveland",130,1753,107,2,1883,21,2020-08-24,8226
"Columbia",281,3401,230,12,3682,39,2020-08-24,23892
"Conway",189,4469,167,3,4658,19,2020-08-24,20906
"Craighead",1696,21879,1448,14,23575,234,2020-08-24,105701
"Crawford",839,12699,688,6,13538,145,2020-08-24,62472
"Crittenden",1582,11152,1450,28,12734,104,2020-08-24,49013
"Cross",241,2934,212,4,3175,25,2020-08-24,16998
"Dallas",90,1285,64,2,1375,24,2020-08-24,7432
"Desha",223,2825,199,4,3048,20,2020-08-24,11887
"Drew",296,4292,238,4,4588,54,2020-08-24,18502
"Faulkner",1535,25235,1384,7,26770,144,2020-08-24,122416
"Franklin",153,3827,137,2,3980,14,2020-08-24,17780
"Fulton",60,782,43,0,842,17,2020-08-24,12139
"Garland",1308,20146,1119,25,21454,164,2020-08-24,98298
"Grant",169,3297,150,0,3466,19,2020-08-24,18086
"Greene",584,8958,519,3,9542,62,2020-08-24,44623
"Hempstead",307,3310,267,3,3617,37,2020-08-24,22018
"Hot Spring",1681,8005,1593,17,9686,71,2020-08-24,33520
"Howard",393,3033,355,5,3426,33,2020-08-24,13389
"Independence",692,7032,592,3,7724,97,2020-08-24,37264
"Izard",81,2571,59,0,2652,22,2020-08-24,13559
"Jackson",176,4164,121,1,4340,54,2020-08-24,17225
"Jefferson",1904,19546,1595,44,21450,265,2020-08-24,70424
"Johnson",739,5338,692,3,6077,44,2020-08-24,26291
"Lafayette",65,768,58,2,833,5,2020-08-24,6915
"Lawrence",245,2394,216,10,2639,19,2020-08-24,16669
"Lee",993,3191,961,10,4184,22,2020-08-24,9398
"Lincoln",1375,4915,1220,13,6290,142,2020-08-24,13695
"Little River",258,1395,206,13,1653,39,2020-08-24,12417
"Logan",351,5034,289,1,5385,61,2020-08-24,21757
"Lonoke",652,11680,553,2,12332,97,2020-08-24,72206
"Madison",286,2999,278,2,3285,6,2020-08-24,16078
"Marion",41,1544,32,0,1585,9,2020-08-24,16438
"Miller",572,4662,527,5,5234,40,2020-08-24,43759
"Mississippi",1268,8904,1103,17,10172,148,2020-08-24,42831
"Monroe",89,1672,73,0,1761,16,2020-08-24,7249
"Montgomery",60,1143,38,2,1203,20,2020-08-24,8993
"Nevada",156,2120,136,11,2276,9,2020-08-24,8440
"Newton",109,1099,90,15,1208,4,2020-08-24,7848
"Ouachita",132,3941,111,4,4073,17,2020-08-24,24106
"Perry",59,2014,56,0,2073,3,2020-08-24,10322
"Phillips",375,4860,329,9,5235,37,2020-08-24,19034
"Pike",157,1665,127,1,1822,29,2020-08-24,10808
"Poinsett",429,5094,320,4,5523,105,2020-08-24,24054
"Polk",207,2917,170,2,3124,35,2020-08-24,20163
"Pope",1593,15086,1391,14,16679,188,2020-08-24,63644
"Prairie",114,1477,106,0,1591,8,2020-08-24,8244
"Pulaski",6590,86717,5862,98,93307,630,2020-08-24,393463
"Randolph",290,3476,239,12,3766,39,2020-08-24,17603
"Saline",1384,18242,1176,10,19626,198,2020-08-24,118009
"Scott",84,1362,76,0,1446,8,2020-08-24,10442
"Searcy",62,1407,32,0,1469,30,2020-08-24,7923
"Sebastian",2686,29556,2328,29,32242,329,2020-08-24,127461
"Sevier",1121,5392,1056,12,6513,53,2020-08-24,17193
"Sharp",136,2628,116,5,2764,15,2020-08-24,17043
"St. Francis",1280,8568,1231,3,9848,46,2020-08-24,26294
"Stone",155,2133,85,1,2288,69,2020-08-24,12446
"Union",634,6553,556,21,7187,57,2020-08-24,39732
"Van Buren",84,2683,60,2,2767,22,2020-08-24,16684
"Washington",6615,49462,6370,54,56077,191,2020-08-24,228529
"White",462,9365,354,8,9827,100,2020-08-24,78804
"Woodruff",27,1260,22,0,1287,5,2020-08-24,6660
"Yell",1111,7221,1059,21,8332,31,2020-08-24,21757
"Arkansas",265,3814,236,2,4079,27,2020-08-23,18124
"Ashley",379,3832,346,7,4211,26,2020-08-23,20537
"Baxter",116,2170,80,0,2286,36,2020-08-23,41219
"Benton",5092,51813,4841,45,56905,206,2020-08-23,258980
"Boone",266,5673,224,1,5939,41,2020-08-23,37288
"Bradley",260,2785,204,4,3045,52,2020-08-23,10948
"Calhoun",23,1193,16,0,1216,7,2020-08-23,5202
"Carroll",432,5123,364,7,5555,61,2020-08-23,27887
"Chicot",938,3937,730,10,4875,198,2020-08-23,10826
"Clark",208,4299,182,3,4507,23,2020-08-23,22385
"Clay",164,2804,136,5,2968,23,2020-08-23,15061
"Cleburne",244,4024,213,6,4268,25,2020-08-23,25230
"Cleveland",129,1739,104,2,1868,23,2020-08-23,8226
"Columbia",274,3373,228,12,3647,34,2020-08-23,23892
"Conway",189,4431,164,3,4620,22,2020-08-23,20906
"Craighead",1682,21638,1431,14,23320,237,2020-08-23,105701
"Crawford",835,12525,676,6,13360,153,2020-08-23,62472
"Crittenden",1573,11117,1436,28,12690,109,2020-08-23,49013
"Cross",240,2870,210,4,3110,26,2020-08-23,16998
"Dallas",90,1279,63,2,1369,25,2020-08-23,7432
"Desha",223,2801,195,4,3024,24,2020-08-23,11887
"Drew",296,4242,231,4,4538,61,2020-08-23,18502
"Faulkner",1500,25038,1377,7,26538,116,2020-08-23,122416
"Franklin",152,3779,136,2,3931,14,2020-08-23,17780
"Fulton",59,771,43,0,830,16,2020-08-23,12139
"Garland",1296,19989,1105,25,21285,166,2020-08-23,98298
"Grant",168,3271,143,0,3439,25,2020-08-23,18086
"Greene",584,8872,516,3,9456,65,2020-08-23,44623
"Hempstead",306,3289,258,3,3595,45,2020-08-23,22018
"Hot Spring",1678,7970,1587,17,9648,74,2020-08-23,33520
"Howard",391,3024,345,5,3415,41,2020-08-23,13389
"Independence",684,6916,584,3,7600,97,2020-08-23,37264
"Izard",81,2559,58,0,2640,23,2020-08-23,13559
"Jackson",176,4156,121,1,4332,54,2020-08-23,17225
"Jefferson",1899,19344,1584,43,21243,272,2020-08-23,70424
"Johnson",735,5248,687,3,5983,45,2020-08-23,26291
"Lafayette",65,766,58,2,831,5,2020-08-23,6915
"Lawrence",240,2380,214,10,2620,16,2020-08-23,16669
"Lee",992,3154,962,8,4146,22,2020-08-23,9398
"Lincoln",1375,4890,1220,13,6265,142,2020-08-23,13695
"Little River",256,1389,204,13,1645,39,2020-08-23,12417
"Logan",347,4985,288,1,5332,58,2020-08-23,21757
"Lonoke",651,11575,549,2,12226,100,2020-08-23,72206
"Madison",286,2983,278,2,3269,6,2020-08-23,16078
"Marion",41,1530,31,0,1571,10,2020-08-23,16438
"Miller",571,4632,526,5,5203,40,2020-08-23,43759
"Mississippi",1261,8853,1084,16,10114,161,2020-08-23,42831
"Monroe",89,1653,68,0,1742,21,2020-08-23,7249
"Montgomery",58,1123,37,2,1181,19,2020-08-23,8993
"Nevada",156,2112,136,11,2268,9,2020-08-23,8440
"Newton",108,1084,90,15,1192,3,2020-08-23,7848
"Ouachita",130,3894,110,4,4024,16,2020-08-23,24106
"Perry",59,2003,56,0,2062,3,2020-08-23,10322
"Phillips",375,4849,327,9,5224,39,2020-08-23,19034
"Pike",156,1658,122,1,1814,33,2020-08-23,10808
"Poinsett",406,5057,310,4,5463,92,2020-08-23,24054
"Polk",204,2890,166,2,3094,36,2020-08-23,20163
"Pope",1591,14982,1377,14,16573,200,2020-08-23,63644
"Prairie",114,1462,106,0,1576,8,2020-08-23,8244
"Pulaski",6533,86102,5813,95,92635,625,2020-08-23,393463
"Randolph",290,3446,234,11,3736,45,2020-08-23,17603
"Saline",1375,18100,1155,10,19475,210,2020-08-23,118009
"Scott",84,1351,75,0,1435,9,2020-08-23,10442
"Searcy",58,1397,32,0,1455,26,2020-08-23,7923
"Sebastian",2679,29187,2297,29,31866,353,2020-08-23,127461
"Sevier",1120,5366,1047,12,6486,61,2020-08-23,17193
"Sharp",136,2604,116,5,2740,15,2020-08-23,17043
"St. Francis",1270,8503,1227,3,9773,40,2020-08-23,26294
"Stone",153,2115,84,1,2268,68,2020-08-23,12446
"Union",627,6526,552,21,7153,54,2020-08-23,39732
"Van Buren",80,2666,58,2,2746,20,2020-08-23,16684
"Washington",6610,49015,6351,54,55625,205,2020-08-23,228529
"White",455,9301,344,8,9756,103,2020-08-23,78804
"Woodruff",27,1245,22,0,1272,5,2020-08-23,6660
"Yell",1109,7199,1055,21,8308,33,2020-08-23,21757
"Arkansas",263,3770,235,2,4033,26,2020-08-22,18124
"Ashley",376,3812,342,7,4188,27,2020-08-22,20537
"Baxter",107,2155,80,0,2262,27,2020-08-22,41219
"Benton",5066,51639,4828,45,56705,193,2020-08-22,258980
"Boone",257,5665,219,1,5922,37,2020-08-22,37288
"Bradley",251,2782,198,4,3033,49,2020-08-22,10948
"Calhoun",23,1193,16,0,1216,7,2020-08-22,5202
"Carroll",429,5094,361,7,5523,61,2020-08-22,27887
"Chicot",935,3921,728,9,4856,198,2020-08-22,10826
"Clark",206,4290,179,3,4496,24,2020-08-22,22385
"Clay",162,2790,134,5,2952,23,2020-08-22,15061
"Cleburne",243,4000,209,5,4243,29,2020-08-22,25230
"Cleveland",127,1729,102,2,1856,23,2020-08-22,8226
"Columbia",273,3366,226,12,3639,35,2020-08-22,23892
"Conway",188,4406,160,3,4594,25,2020-08-22,20906
"Craighead",1675,21473,1421,14,23148,240,2020-08-22,105701
"Crawford",827,12392,668,6,13219,153,2020-08-22,62472
"Crittenden",1563,11085,1422,27,12648,114,2020-08-22,49013
"Cross",238,2866,205,4,3104,29,2020-08-22,16998
"Dallas",88,1276,61,2,1364,25,2020-08-22,7432
"Desha",220,2793,194,4,3013,22,2020-08-22,11887
"Drew",296,4230,228,4,4526,64,2020-08-22,18502
"Faulkner",1485,24873,1365,7,26358,113,2020-08-22,122416
"Franklin",149,3769,134,2,3918,13,2020-08-22,17780
"Fulton",55,766,42,0,821,13,2020-08-22,12139
"Garland",1288,19936,1092,23,21224,173,2020-08-22,98298
"Grant",164,3254,143,0,3418,21,2020-08-22,18086
"Greene",574,8801,509,3,9375,62,2020-08-22,44623
"Hempstead",303,3262,258,3,3565,42,2020-08-22,22018
"Hot Spring",1677,7953,1571,16,9630,90,2020-08-22,33520
"Howard",389,3012,345,4,3401,40,2020-08-22,13389
"Independence",676,6843,571,3,7519,102,2020-08-22,37264
"Izard",78,2541,58,0,2619,20,2020-08-22,13559
"Jackson",171,3686,117,1,3857,53,2020-08-22,17225
"Jefferson",1881,19223,1571,43,21104,267,2020-08-22,70424
"Johnson",734,5224,683,3,5958,48,2020-08-22,26291
"Lafayette",65,760,57,2,825,6,2020-08-22,6915
"Lawrence",239,2365,213,10,2604,16,2020-08-22,16669
"Lee",991,3143,959,8,4134,24,2020-08-22,9398
"Lincoln",1374,4871,1218,13,6245,143,2020-08-22,13695
"Little River",254,1386,200,13,1640,41,2020-08-22,12417
"Logan",347,4969,280,1,5316,66,2020-08-22,21757
"Lonoke",642,11506,544,2,12148,96,2020-08-22,72206
"Madison",286,2972,278,2,3258,6,2020-08-22,16078
"Marion",41,1527,31,0,1568,10,2020-08-22,16438
"Miller",566,4618,519,5,5184,42,2020-08-22,43759
"Mississippi",1249,8777,1065,16,10026,168,2020-08-22,42831
"Monroe",89,1628,65,0,1717,24,2020-08-22,7249
"Montgomery",57,1113,36,2,1170,19,2020-08-22,8993
"Nevada",156,2099,136,10,2255,10,2020-08-22,8440
"Newton",108,1083,90,15,1191,3,2020-08-22,7848
"Ouachita",129,3887,110,3,4016,16,2020-08-22,24106
"Perry",59,1992,55,0,2051,4,2020-08-22,10322
"Phillips",374,4826,323,9,5200,42,2020-08-22,19034
"Pike",154,1652,118,1,1806,35,2020-08-22,10808
"Poinsett",398,4903,304,4,5301,90,2020-08-22,24054
"Polk",200,2882,163,2,3082,35,2020-08-22,20163
"Pope",1580,14866,1359,14,16446,207,2020-08-22,63644
"Prairie",114,1443,105,0,1557,9,2020-08-22,8244
"Pulaski",6477,85639,5746,94,92116,637,2020-08-22,393463
"Randolph",288,3429,229,11,3717,48,2020-08-22,17603
"Saline",1367,17971,1112,10,19338,245,2020-08-22,118009
"Scott",84,1348,73,0,1432,11,2020-08-22,10442
"Searcy",58,1373,32,0,1431,26,2020-08-22,7923
"Sebastian",2666,28943,2273,27,31609,366,2020-08-22,127461
"Sevier",1114,5341,1039,12,6455,63,2020-08-22,17193
"Sharp",132,2587,115,5,2719,12,2020-08-22,17043
"St. Francis",1263,8468,1214,3,9731,46,2020-08-22,26294
"Stone",151,2111,79,1,2262,71,2020-08-22,12446
"Union",624,6512,538,21,7136,65,2020-08-22,39732
"Van Buren",75,2654,57,2,2729,16,2020-08-22,16684
"Washington",6597,48764,6335,53,55361,209,2020-08-22,228529
"White",448,9278,333,8,9726,107,2020-08-22,78804
"Woodruff",26,1242,22,0,1268,4,2020-08-22,6660
"Yell",1107,7155,1053,21,8262,33,2020-08-22,21757
"Arkansas",258,3735,234,2,3993,22,2020-08-21,18124
"Ashley",372,3785,338,7,4157,27,2020-08-21,20537
"Baxter",102,2150,79,0,2252,23,2020-08-21,41219
"Benton",5046,51527,4803,44,56573,199,2020-08-21,258980
"Boone",251,5640,217,1,5891,33,2020-08-21,37288
"Bradley",243,2773,191,4,3016,48,2020-08-21,10948
"Calhoun",22,1192,16,0,1214,6,2020-08-21,5202
"Carroll",422,5076,357,7,5498,58,2020-08-21,27887
"Chicot",933,3898,722,9,4831,202,2020-08-21,10826
"Clark",201,4264,177,3,4465,21,2020-08-21,22385
"Clay",159,2774,129,5,2933,25,2020-08-21,15061
"Cleburne",242,3979,207,5,4221,30,2020-08-21,25230
"Cleveland",127,1722,97,2,1849,28,2020-08-21,8226
"Columbia",265,3308,225,12,3573,28,2020-08-21,23892
"Conway",184,4370,157,3,4554,24,2020-08-21,20906
"Craighead",1621,21115,1410,13,22736,198,2020-08-21,105701
"Crawford",814,12286,650,6,13100,158,2020-08-21,62472
"Crittenden",1554,11046,1414,27,12600,113,2020-08-21,49013
"Cross",236,2852,201,4,3088,31,2020-08-21,16998
"Dallas",86,1271,60,2,1357,24,2020-08-21,7432
"Desha",218,2786,190,4,3004,24,2020-08-21,11887
"Drew",292,4194,224,4,4486,64,2020-08-21,18502
"Faulkner",1468,24706,1346,7,26174,115,2020-08-21,122416
"Franklin",148,3757,131,2,3905,15,2020-08-21,17780
"Fulton",55,757,42,0,812,13,2020-08-21,12139
"Garland",1276,19849,1054,23,21125,199,2020-08-21,98298
"Grant",164,3240,141,0,3404,23,2020-08-21,18086
"Greene",570,8760,501,3,9330,66,2020-08-21,44623
"Hempstead",294,3251,256,3,3545,35,2020-08-21,22018
"Hot Spring",1675,7911,1561,15,9586,99,2020-08-21,33520
"Howard",386,3004,344,4,3390,38,2020-08-21,13389
"Independence",669,6827,559,3,7496,107,2020-08-21,37264
"Izard",72,2381,57,0,2453,15,2020-08-21,13559
"Jackson",160,3451,86,1,3611,73,2020-08-21,17225
"Jefferson",1861,19034,1556,43,20895,262,2020-08-21,70424
"Johnson",726,5202,682,3,5928,41,2020-08-21,26291
"Lafayette",65,756,57,2,821,6,2020-08-21,6915
"Lawrence",239,2338,213,9,2577,17,2020-08-21,16669
"Lee",988,3133,957,8,4121,23,2020-08-21,9398
"Lincoln",1371,4865,1210,12,6236,149,2020-08-21,13695
"Little River",252,1383,199,13,1635,40,2020-08-21,12417
"Logan",344,4947,275,1,5291,68,2020-08-21,21757
"Lonoke",635,11303,536,2,11938,97,2020-08-21,72206
"Madison",286,2963,278,2,3249,6,2020-08-21,16078
"Marion",40,1524,30,0,1564,10,2020-08-21,16438
"Miller",552,4146,516,5,4698,31,2020-08-21,43759
"Mississippi",1231,8721,1029,16,9952,186,2020-08-21,42831
"Monroe",86,1613,64,0,1699,22,2020-08-21,7249
"Montgomery",58,1096,32,2,1154,24,2020-08-21,8993
"Nevada",151,2092,133,9,2243,9,2020-08-21,8440
"Newton",108,1074,90,15,1182,3,2020-08-21,7848
"Ouachita",128,3883,105,3,4011,20,2020-08-21,24106
"Perry",58,1983,54,0,2041,4,2020-08-21,10322
"Phillips",370,4799,313,9,5169,48,2020-08-21,19034
"Pike",154,1649,115,1,1803,38,2020-08-21,10808
"Poinsett",387,4837,301,4,5224,82,2020-08-21,24054
"Polk",199,2869,159,2,3068,38,2020-08-21,20163
"Pope",1555,14710,1343,14,16265,198,2020-08-21,63644
"Prairie",113,1414,103,0,1527,10,2020-08-21,8244
"Pulaski",6436,85085,5636,91,91521,709,2020-08-21,393463
"Randolph",287,3414,225,11,3701,51,2020-08-21,17603
"Saline",1352,17866,1074,10,19218,268,2020-08-21,118009
"Scott",84,1344,73,0,1428,11,2020-08-21,10442
"Searcy",45,1298,32,0,1343,13,2020-08-21,7923
"Sebastian",2622,28743,2235,27,31365,360,2020-08-21,127461
"Sevier",1109,5310,1028,12,6419,69,2020-08-21,17193
"Sharp",132,2577,115,5,2709,12,2020-08-21,17043
"St. Francis",1258,8420,1209,3,9678,46,2020-08-21,26294
"Stone",143,2100,75,1,2243,67,2020-08-21,12446
"Union",612,6352,528,21,6964,63,2020-08-21,39732
"Van Buren",74,2642,57,2,2716,15,2020-08-21,16684
"Washington",6582,48560,6312,53,55142,217,2020-08-21,228529
"White",439,9232,328,7,9671,104,2020-08-21,78804
"Woodruff",26,1237,22,0,1263,4,2020-08-21,6660
"Yell",1104,7122,1051,20,8226,33,2020-08-21,21757
"Arkansas",256,3696,230,2,3952,24,2020-08-20,18124
"Ashley",369,3730,331,7,4099,31,2020-08-20,20537
"Baxter",96,2105,78,0,2201,18,2020-08-20,41219
"Benton",5000,51029,4774,43,56029,183,2020-08-20,258980
"Boone",242,5567,215,2,5809,25,2020-08-20,37288
"Bradley",233,2738,189,4,2971,40,2020-08-20,10948
"Calhoun",22,1151,16,0,1173,6,2020-08-20,5202
"Carroll",409,5013,352,7,5422,50,2020-08-20,27887
"Chicot",932,3869,714,9,4801,209,2020-08-20,10826
"Clark",196,4244,177,2,4440,17,2020-08-20,22385
"Clay",154,2742,126,5,2896,23,2020-08-20,15061
"Cleburne",237,3929,204,5,4166,28,2020-08-20,25230
"Cleveland",124,1693,97,2,1817,25,2020-08-20,8226
"Columbia",255,3288,222,12,3543,21,2020-08-20,23892
"Conway",178,4335,147,3,4513,28,2020-08-20,20906
"Craighead",1598,20957,1390,13,22555,195,2020-08-20,105701
"Crawford",790,12128,638,6,12918,146,2020-08-20,62472
"Crittenden",1530,10981,1383,26,12511,121,2020-08-20,49013
"Cross",236,2829,197,4,3065,35,2020-08-20,16998
"Dallas",70,1249,60,2,1319,8,2020-08-20,7432
"Desha",213,2753,188,4,2966,21,2020-08-20,11887
"Drew",286,4136,215,3,4422,68,2020-08-20,18502
"Faulkner",1438,24429,1315,7,25867,116,2020-08-20,122416
"Franklin",147,3714,130,2,3861,15,2020-08-20,17780
"Fulton",52,747,42,0,799,10,2020-08-20,12139
"Garland",1256,19706,1032,21,20962,203,2020-08-20,98298
"Grant",159,3202,140,0,3361,19,2020-08-20,18086
"Greene",563,8575,492,3,9138,68,2020-08-20,44623
"Hempstead",284,3217,249,3,3501,32,2020-08-20,22018
"Hot Spring",1659,7853,1523,14,9512,122,2020-08-20,33520
"Howard",383,2988,337,3,3371,43,2020-08-20,13389
"Independence",651,6729,542,3,7380,106,2020-08-20,37264
"Izard",69,1832,56,0,1901,13,2020-08-20,13559
"Jackson",155,3215,83,1,3370,71,2020-08-20,17225
"Jefferson",1831,17351,1533,41,19182,257,2020-08-20,70424
"Johnson",724,5139,681,3,5863,40,2020-08-20,26291
"Lafayette",64,747,57,2,811,5,2020-08-20,6915
"Lawrence",238,2290,211,9,2528,18,2020-08-20,16669
"Lee",986,3098,957,8,4084,21,2020-08-20,9398
"Lincoln",1360,4822,1204,12,6182,144,2020-08-20,13695
"Little River",248,1369,201,6,1617,41,2020-08-20,12417
"Logan",343,4885,267,1,5228,75,2020-08-20,21757
"Lonoke",611,11113,522,2,11724,87,2020-08-20,72206
"Madison",286,2942,278,2,3228,6,2020-08-20,16078
"Marion",38,1504,30,0,1542,8,2020-08-20,16438
"Miller",541,4121,507,5,4662,29,2020-08-20,43759
"Mississippi",1216,8609,1009,16,9825,191,2020-08-20,42831
"Monroe",84,1571,62,0,1655,22,2020-08-20,7249
"Montgomery",56,1077,32,2,1133,22,2020-08-20,8993
"Nevada",150,2077,133,9,2227,8,2020-08-20,8440
"Newton",107,1063,92,12,1170,3,2020-08-20,7848
"Ouachita",124,3838,104,3,3962,17,2020-08-20,24106
"Perry",56,1966,53,0,2022,3,2020-08-20,10322
"Phillips",366,4761,313,9,5127,44,2020-08-20,19034
"Pike",151,1628,109,1,1779,41,2020-08-20,10808
"Poinsett",367,4707,291,4,5074,72,2020-08-20,24054
"Polk",191,2829,154,2,3020,35,2020-08-20,20163
"Pope",1520,14492,1318,14,16012,188,2020-08-20,63644
"Prairie",112,1390,97,0,1502,15,2020-08-20,8244
"Pulaski",6341,84242,5562,91,90583,688,2020-08-20,393463
"Randolph",285,3376,222,11,3661,52,2020-08-20,17603
"Saline",1334,17656,1053,10,18990,271,2020-08-20,118009
"Scott",84,1331,70,0,1415,14,2020-08-20,10442
"Searcy",39,1286,31,0,1325,8,2020-08-20,7923
"Sebastian",2583,28077,2188,27,30660,368,2020-08-20,127461
"Sevier",1086,5293,1015,11,6379,60,2020-08-20,17193
"Sharp",130,2546,112,5,2676,13,2020-08-20,17043
"St. Francis",1252,8175,1201,3,9427,48,2020-08-20,26294
"Stone",113,2062,74,1,2175,38,2020-08-20,12446
"Union",597,6322,518,21,6919,58,2020-08-20,39732
"Van Buren",70,2620,55,2,2690,13,2020-08-20,16684
"Washington",6517,47938,6283,53,54455,181,2020-08-20,228529
"White",422,9173,328,5,9595,89,2020-08-20,78804
"Woodruff",26,1220,22,0,1246,4,2020-08-20,6660
"Yell",1100,7074,1049,20,8174,31,2020-08-20,21757
"Arkansas",255,3669,229,2,3924,24,2020-08-19,18124
"Ashley",367,3702,322,6,4069,39,2020-08-19,20537
"Baxter",91,2064,74,0,2155,17,2020-08-19,41219
"Benton",4980,50651,4747,43,55631,190,2020-08-19,258980
"Boone",238,5550,208,2,5788,28,2020-08-19,37288
"Bradley",231,2710,186,4,2941,41,2020-08-19,10948
"Calhoun",22,1147,15,0,1169,7,2020-08-19,5202
"Carroll",408,5001,351,7,5409,50,2020-08-19,27887
"Chicot",931,3854,706,9,4785,216,2020-08-19,10826
"Clark",196,4230,177,2,4426,17,2020-08-19,22385
"Clay",150,2725,123,5,2875,22,2020-08-19,15061
"Cleburne",233,3894,197,5,4127,31,2020-08-19,25230
"Cleveland",124,1676,94,2,1800,28,2020-08-19,8226
"Columbia",252,3271,220,12,3523,20,2020-08-19,23892
"Conway",175,4291,145,3,4466,27,2020-08-19,20906
"Craighead",1560,20722,1366,13,22282,181,2020-08-19,105701
"Crawford",768,11991,617,5,12759,146,2020-08-19,62472
"Crittenden",1515,10929,1365,26,12444,124,2020-08-19,49013
"Cross",233,2798,194,4,3031,35,2020-08-19,16998
"Dallas",70,1233,61,2,1303,7,2020-08-19,7432
"Desha",212,2724,181,3,2936,28,2020-08-19,11887
"Drew",283,4130,208,3,4413,72,2020-08-19,18502
"Faulkner",1422,24252,1308,7,25674,107,2020-08-19,122416
"Franklin",147,3679,128,2,3826,17,2020-08-19,17780
"Fulton",51,741,37,0,792,14,2020-08-19,12139
"Garland",1233,19566,1013,19,20799,201,2020-08-19,98298
"Grant",157,3186,140,0,3343,17,2020-08-19,18086
"Greene",559,8436,479,3,8995,77,2020-08-19,44623
"Hempstead",277,3215,245,3,3492,29,2020-08-19,22018
"Hot Spring",1655,7787,1510,14,9442,131,2020-08-19,33520
"Howard",380,2965,334,3,3345,43,2020-08-19,13389
"Independence",635,6473,508,3,7108,124,2020-08-19,37264
"Izard",69,1541,54,0,1610,15,2020-08-19,13559
"Jackson",153,2841,70,1,2994,82,2020-08-19,17225
"Jefferson",1776,16892,1473,41,18668,262,2020-08-19,70424
"Johnson",717,5113,676,2,5830,39,2020-08-19,26291
"Lafayette",63,742,56,2,805,5,2020-08-19,6915
"Lawrence",234,2269,210,9,2503,15,2020-08-19,16669
"Lee",983,3088,956,8,4071,19,2020-08-19,9398
"Lincoln",1356,4670,1200,12,6026,144,2020-08-19,13695
"Little River",237,1363,193,5,1600,39,2020-08-19,12417
"Logan",339,4853,261,1,5192,77,2020-08-19,21757
"Lonoke",604,11001,511,2,11605,91,2020-08-19,72206
"Madison",284,2927,277,2,3211,5,2020-08-19,16078
"Marion",37,1483,30,0,1520,7,2020-08-19,16438
"Miller",546,4096,507,5,4642,34,2020-08-19,43759
"Mississippi",1196,8524,981,16,9720,199,2020-08-19,42831
"Monroe",81,1549,60,0,1630,21,2020-08-19,7249
"Montgomery",53,1065,32,1,1118,20,2020-08-19,8993
"Nevada",147,2066,130,9,2213,8,2020-08-19,8440
"Newton",107,1059,92,11,1166,4,2020-08-19,7848
"Ouachita",120,3803,98,3,3923,19,2020-08-19,24106
"Perry",55,1953,50,0,2008,5,2020-08-19,10322
"Phillips",360,4736,311,9,5096,40,2020-08-19,19034
"Pike",151,1616,104,1,1767,46,2020-08-19,10808
"Poinsett",358,4662,277,4,5020,77,2020-08-19,24054
"Polk",186,2813,145,2,2999,39,2020-08-19,20163
"Pope",1499,14336,1311,14,15835,174,2020-08-19,63644
"Prairie",112,1375,93,0,1487,19,2020-08-19,8244
"Pulaski",6284,83199,5385,91,89483,808,2020-08-19,393463
"Randolph",280,3345,217,11,3625,52,2020-08-19,17603
"Saline",1319,17484,1034,10,18803,275,2020-08-19,118009
"Scott",80,1308,63,0,1388,17,2020-08-19,10442
"Searcy",37,1287,31,0,1324,6,2020-08-19,7923
"Sebastian",2552,27578,2146,27,30130,379,2020-08-19,127461
"Sevier",1079,5272,1009,11,6351,59,2020-08-19,17193
"Sharp",128,2528,111,5,2656,12,2020-08-19,17043
"St. Francis",1245,8147,1173,3,9392,69,2020-08-19,26294
"Stone",98,2047,71,1,2145,26,2020-08-19,12446
"Union",589,6247,506,21,6836,62,2020-08-19,39732
"Van Buren",64,2606,53,2,2670,9,2020-08-19,16684
"Washington",6507,47292,6256,53,53799,198,2020-08-19,228529
"White",412,9142,319,5,9554,88,2020-08-19,78804
"Woodruff",26,1211,22,0,1237,4,2020-08-19,6660
"Yell",1097,7036,1046,19,8133,32,2020-08-19,21757
"Arkansas",251,3629,222,2,3880,27,2020-08-18,18124
"Ashley",362,3657,310,6,4019,46,2020-08-18,20537
"Baxter",89,2039,73,0,2128,16,2020-08-18,41219
"Benton",4950,50343,4720,43,55293,187,2020-08-18,258980
"Boone",232,5512,201,2,5744,29,2020-08-18,37288
"Bradley",230,2693,180,4,2923,46,2020-08-18,10948
"Calhoun",22,1141,15,0,1163,7,2020-08-18,5202
"Carroll",401,4978,348,7,5379,46,2020-08-18,27887
"Chicot",926,3846,665,9,4772,252,2020-08-18,10826
"Clark",195,4213,175,2,4408,18,2020-08-18,22385
"Clay",147,2717,121,5,2864,21,2020-08-18,15061
"Cleburne",229,3877,191,5,4106,33,2020-08-18,25230
"Cleveland",121,1669,93,2,1790,26,2020-08-18,8226
"Columbia",250,3261,214,12,3511,24,2020-08-18,23892
"Conway",169,4264,144,3,4433,22,2020-08-18,20906
"Craighead",1512,20531,1345,14,22043,153,2020-08-18,105701
"Crawford",757,11877,598,5,12634,154,2020-08-18,62472
"Crittenden",1503,10882,1342,26,12385,135,2020-08-18,49013
"Cross",229,2780,191,4,3009,34,2020-08-18,16998
"Dallas",71,1229,61,2,1300,8,2020-08-18,7432
"Desha",212,2714,175,3,2926,34,2020-08-18,11887
"Drew",277,4107,196,3,4384,78,2020-08-18,18502
"Faulkner",1412,24086,1296,7,25498,109,2020-08-18,122416
"Franklin",146,3655,128,2,3801,16,2020-08-18,17780
"Fulton",51,735,35,0,786,16,2020-08-18,12139
"Garland",1207,19375,981,18,20582,208,2020-08-18,98298
"Grant",157,3169,139,0,3326,18,2020-08-18,18086
"Greene",548,8383,470,3,8931,75,2020-08-18,44623
"Hempstead",272,3213,238,2,3485,32,2020-08-18,22018
"Hot Spring",1647,7739,1497,14,9386,136,2020-08-18,33520
"Howard",376,2950,319,4,3326,53,2020-08-18,13389
"Independence",626,6437,495,2,7063,129,2020-08-18,37264
"Izard",65,1529,53,0,1594,12,2020-08-18,13559
"Jackson",131,2835,67,1,2966,63,2020-08-18,17225
"Jefferson",1718,16843,1439,41,18561,238,2020-08-18,70424
"Johnson",695,5074,669,2,5769,24,2020-08-18,26291
"Lafayette",62,740,54,2,802,6,2020-08-18,6915
"Lawrence",232,2248,208,9,2480,15,2020-08-18,16669
"Lee",983,3080,957,8,4063,18,2020-08-18,9398
"Lincoln",1355,4665,1200,12,6020,143,2020-08-18,13695
"Little River",227,1355,187,4,1582,36,2020-08-18,12417
"Logan",337,4827,244,1,5164,92,2020-08-18,21757
"Lonoke",589,10931,499,2,11520,88,2020-08-18,72206
"Madison",280,2904,272,2,3184,6,2020-08-18,16078
"Marion",34,1468,30,0,1502,4,2020-08-18,16438
"Miller",541,4083,503,5,4624,33,2020-08-18,43759
"Mississippi",1164,8469,963,15,9633,186,2020-08-18,42831
"Monroe",79,1533,58,0,1612,21,2020-08-18,7249
"Montgomery",45,1061,28,1,1106,16,2020-08-18,8993
"Nevada",147,2059,129,9,2206,9,2020-08-18,8440
"Newton",107,1052,91,11,1159,5,2020-08-18,7848
"Ouachita",118,3790,96,3,3908,19,2020-08-18,24106
"Perry",55,1948,50,0,2003,5,2020-08-18,10322
"Phillips",357,4718,310,9,5075,38,2020-08-18,19034
"Pike",146,1604,101,1,1750,44,2020-08-18,10808
"Poinsett",350,4628,264,4,4978,82,2020-08-18,24054
"Polk",177,2796,139,1,2973,37,2020-08-18,20163
"Pope",1468,14235,1298,12,15703,158,2020-08-18,63644
"Prairie",112,1368,92,0,1480,20,2020-08-18,8244
"Pulaski",6201,82547,5317,91,88748,793,2020-08-18,393463
"Randolph",271,3338,214,11,3609,46,2020-08-18,17603
"Saline",1293,17337,1018,9,18630,266,2020-08-18,118009
"Scott",79,1305,61,0,1384,18,2020-08-18,10442
"Searcy",35,1279,31,0,1314,4,2020-08-18,7923
"Sebastian",2499,27302,2106,23,29801,370,2020-08-18,127461
"Sevier",1074,5231,996,11,6305,67,2020-08-18,17193
"Sharp",126,2520,108,5,2646,13,2020-08-18,17043
"St. Francis",1243,8124,1166,3,9367,74,2020-08-18,26294
"Stone",91,2031,66,1,2122,24,2020-08-18,12446
"Union",578,6241,498,21,6819,59,2020-08-18,39732
"Van Buren",62,2591,52,2,2653,8,2020-08-18,16684
"Washington",6472,47011,6222,53,53483,197,2020-08-18,228529
"White",409,9104,312,4,9513,93,2020-08-18,78804
"Woodruff",25,1204,22,0,1229,3,2020-08-18,6660
"Yell",1093,7007,1043,19,8100,31,2020-08-18,21757
"Arkansas",249,3615,219,2,3864,28,2020-08-17,18124
"Ashley",363,3653,299,6,4016,58,2020-08-17,20537
"Baxter",89,2007,70,0,2096,19,2020-08-17,41219
"Benton",4933,50112,4691,43,55045,199,2020-08-17,258980
"Boone",230,5474,198,2,5704,30,2020-08-17,37288
"Bradley",227,2678,166,4,2905,57,2020-08-17,10948
"Calhoun",16,1110,14,0,1126,2,2020-08-17,5202
"Carroll",395,4932,346,7,5327,42,2020-08-17,27887
"Chicot",925,3836,555,9,4761,361,2020-08-17,10826
"Clark",192,4182,171,2,4374,19,2020-08-17,22385
"Clay",147,2696,116,5,2843,26,2020-08-17,15061
"Cleburne",228,3857,188,5,4085,35,2020-08-17,25230
"Cleveland",121,1660,86,2,1781,33,2020-08-17,8226
"Columbia",244,3253,210,12,3497,22,2020-08-17,23892
"Conway",168,4247,142,3,4415,23,2020-08-17,20906
"Craighead",1498,20343,1309,14,21841,175,2020-08-17,105701
"Crawford",746,11780,585,5,12526,156,2020-08-17,62472
"Crittenden",1493,10844,1323,24,12337,146,2020-08-17,49013
"Cross",228,2769,189,4,2997,35,2020-08-17,16998
"Dallas",68,1214,61,2,1282,5,2020-08-17,7432
"Desha",211,2696,172,2,2907,37,2020-08-17,11887
"Drew",270,4082,186,3,4352,81,2020-08-17,18502
"Faulkner",1402,23944,1269,6,25346,127,2020-08-17,122416
"Franklin",141,3633,124,2,3774,15,2020-08-17,17780
"Fulton",49,730,30,0,779,19,2020-08-17,12139
"Garland",1201,19287,945,17,20488,239,2020-08-17,98298
"Grant",154,3150,132,0,3304,22,2020-08-17,18086
"Greene",544,8321,458,3,8865,83,2020-08-17,44623
"Hempstead",271,3194,234,2,3465,35,2020-08-17,22018
"Hot Spring",1644,7726,1489,13,9370,142,2020-08-17,33520
"Howard",376,2938,317,4,3314,55,2020-08-17,13389
"Independence",621,6384,472,2,7005,147,2020-08-17,37264
"Izard",61,1467,52,0,1528,9,2020-08-17,13559
"Jackson",124,2763,64,1,2887,59,2020-08-17,17225
"Jefferson",1710,16754,1415,41,18464,254,2020-08-17,70424
"Johnson",695,5055,661,2,5750,32,2020-08-17,26291
"Lafayette",61,732,53,2,793,6,2020-08-17,6915
"Lawrence",231,2234,204,9,2465,18,2020-08-17,16669
"Lee",979,3070,955,8,4049,16,2020-08-17,9398
"Lincoln",1348,4565,1197,12,5913,139,2020-08-17,13695
"Little River",219,1354,181,3,1573,35,2020-08-17,12417
"Logan",338,4781,233,1,5119,104,2020-08-17,21757
"Lonoke",580,10836,484,2,11416,94,2020-08-17,72206
"Madison",279,2890,272,2,3169,5,2020-08-17,16078
"Marion",34,1444,29,0,1478,5,2020-08-17,16438
"Miller",538,4074,501,5,4612,32,2020-08-17,43759
"Mississippi",1159,8413,928,14,9572,217,2020-08-17,42831
"Monroe",76,1509,56,0,1585,20,2020-08-17,7249
"Montgomery",44,1058,28,1,1102,15,2020-08-17,8993
"Nevada",147,2049,127,9,2196,11,2020-08-17,8440
"Newton",107,1048,90,11,1155,6,2020-08-17,7848
"Ouachita",118,3779,91,3,3897,24,2020-08-17,24106
"Perry",55,1942,50,0,1997,5,2020-08-17,10322
"Phillips",355,4699,306,9,5054,40,2020-08-17,19034
"Pike",144,1595,98,1,1739,45,2020-08-17,10808
"Poinsett",347,4590,250,4,4937,93,2020-08-17,24054
"Polk",171,2767,135,1,2938,35,2020-08-17,20163
"Pope",1465,14135,1283,12,15600,170,2020-08-17,63644
"Prairie",111,1359,89,0,1470,22,2020-08-17,8244
"Pulaski",6146,81986,5228,88,88132,830,2020-08-17,393463
"Randolph",265,3308,210,11,3573,44,2020-08-17,17603
"Saline",1277,17200,992,8,18477,277,2020-08-17,118009
"Scott",78,1302,56,0,1380,22,2020-08-17,10442
"Searcy",34,1278,31,0,1312,3,2020-08-17,7923
"Sebastian",2456,27086,2055,22,29542,379,2020-08-17,127461
"Sevier",1067,5206,986,11,6273,70,2020-08-17,17193
"Sharp",128,2502,104,5,2630,19,2020-08-17,17043
"St. Francis",1243,8079,1163,3,9322,77,2020-08-17,26294
"Stone",87,2016,65,1,2103,21,2020-08-17,12446
"Union",561,6166,485,20,6727,56,2020-08-17,39732
"Van Buren",58,2582,50,2,2640,6,2020-08-17,16684
"Washington",6442,46838,6186,53,53280,203,2020-08-17,228529
"White",408,9066,308,3,9474,97,2020-08-17,78804
"Woodruff",25,1203,21,0,1228,4,2020-08-17,6660
"Yell",1088,6980,1036,18,8068,34,2020-08-17,21757
"Arkansas",247,3589,215,2,3836,30,2020-08-16,18124
"Ashley",362,3576,295,5,3938,62,2020-08-16,20537
"Baxter",86,1963,68,0,2049,18,2020-08-16,41219
"Benton",4917,49087,4670,43,54004,204,2020-08-16,258980
"Boone",230,5343,194,2,5573,34,2020-08-16,37288
"Bradley",221,2614,157,4,2835,60,2020-08-16,10948
"Calhoun",16,1094,14,0,1110,2,2020-08-16,5202
"Carroll",392,4825,345,7,5217,40,2020-08-16,27887
"Chicot",921,3755,541,9,4676,371,2020-08-16,10826
"Clark",189,4133,170,2,4322,17,2020-08-16,22385
"Clay",146,2638,114,4,2784,28,2020-08-16,15061
"Cleburne",225,3820,183,5,4045,37,2020-08-16,25230
"Cleveland",120,1622,84,2,1742,34,2020-08-16,8226
"Columbia",242,3217,204,12,3459,26,2020-08-16,23892
"Conway",162,4099,140,3,4261,19,2020-08-16,20906
"Craighead",1482,19073,1286,13,20555,183,2020-08-16,105701
"Crawford",736,11532,579,5,12268,152,2020-08-16,62472
"Crittenden",1482,10730,1300,24,12212,158,2020-08-16,49013
"Cross",225,2700,186,4,2925,35,2020-08-16,16998
"Dallas",68,1195,60,2,1263,6,2020-08-16,7432
"Desha",210,2650,170,2,2860,38,2020-08-16,11887
"Drew",260,3990,182,3,4250,75,2020-08-16,18502
"Faulkner",1397,23727,1253,6,25124,138,2020-08-16,122416
"Franklin",140,3559,120,2,3699,18,2020-08-16,17780
"Fulton",48,714,30,0,762,18,2020-08-16,12139
"Garland",1182,18909,925,17,20091,240,2020-08-16,98298
"Grant",150,3086,130,0,3236,20,2020-08-16,18086
"Greene",534,8082,454,3,8616,77,2020-08-16,44623
"Hempstead",267,3108,232,2,3375,33,2020-08-16,22018
"Hot Spring",1643,7606,1486,13,9249,144,2020-08-16,33520
"Howard",374,2701,315,4,3075,55,2020-08-16,13389
"Independence",614,6230,456,2,6844,156,2020-08-16,37264
"Izard",61,1431,49,0,1492,12,2020-08-16,13559
"Jackson",124,2740,63,1,2864,60,2020-08-16,17225
"Jefferson",1696,16393,1404,41,18089,251,2020-08-16,70424
"Johnson",691,4984,657,2,5675,32,2020-08-16,26291
"Lafayette",59,718,52,2,777,5,2020-08-16,6915
"Lawrence",230,2196,200,9,2426,21,2020-08-16,16669
"Lee",977,3037,955,8,4014,14,2020-08-16,9398
"Lincoln",1346,4392,1194,12,5738,140,2020-08-16,13695
"Little River",218,1330,178,3,1548,37,2020-08-16,12417
"Logan",337,4699,222,1,5036,114,2020-08-16,21757
"Lonoke",573,10613,479,2,11186,92,2020-08-16,72206
"Madison",278,2836,268,2,3114,8,2020-08-16,16078
"Marion",33,1429,27,0,1462,6,2020-08-16,16438
"Miller",535,4000,498,5,4535,32,2020-08-16,43759
"Mississippi",1154,8201,891,14,9355,249,2020-08-16,42831
"Monroe",76,1475,55,0,1551,21,2020-08-16,7249
"Montgomery",43,1042,28,1,1085,14,2020-08-16,8993
"Nevada",147,2025,127,9,2172,11,2020-08-16,8440
"Newton",107,1021,89,11,1128,7,2020-08-16,7848
"Ouachita",118,3674,87,3,3792,28,2020-08-16,24106
"Perry",55,1892,50,0,1947,5,2020-08-16,10322
"Phillips",349,4565,299,9,4914,41,2020-08-16,19034
"Pike",140,1517,91,1,1657,48,2020-08-16,10808
"Poinsett",340,4522,236,4,4862,100,2020-08-16,24054
"Polk",161,2715,134,1,2876,26,2020-08-16,20163
"Pope",1449,13916,1263,12,15365,174,2020-08-16,63644
"Prairie",109,1316,88,0,1425,21,2020-08-16,8244
"Pulaski",6085,80549,5166,88,86634,831,2020-08-16,393463
"Randolph",260,3262,206,11,3522,43,2020-08-16,17603
"Saline",1267,16938,976,8,18205,283,2020-08-16,118009
"Scott",78,1271,54,0,1349,24,2020-08-16,10442
"Searcy",34,1265,30,0,1299,4,2020-08-16,7923
"Sebastian",2435,26501,2017,22,28936,396,2020-08-16,127461
"Sevier",1058,5110,978,11,6168,69,2020-08-16,17193
"Sharp",128,2459,103,5,2587,20,2020-08-16,17043
"St. Francis",1238,7846,1155,3,9084,80,2020-08-16,26294
"Stone",86,1982,60,1,2068,25,2020-08-16,12446
"Union",556,6064,480,20,6620,56,2020-08-16,39732
"Van Buren",55,2553,49,2,2608,4,2020-08-16,16684
"Washington",6430,45763,6145,53,52193,232,2020-08-16,228529
"White",394,8972,302,3,9366,89,2020-08-16,78804
"Woodruff",24,1158,21,0,1182,3,2020-08-16,6660
"Yell",1088,6899,1033,17,7987,38,2020-08-16,21757
"Arkansas",246,3565,212,2,3811,32,2020-08-15,18124
"Ashley",352,3570,292,5,3922,55,2020-08-15,20537
"Baxter",81,1939,67,0,2020,14,2020-08-15,41219
"Benton",4900,48950,4655,43,53850,202,2020-08-15,258980
"Boone",225,5300,190,2,5525,33,2020-08-15,37288
"Bradley",218,2595,152,4,2813,62,2020-08-15,10948
"Calhoun",16,1090,14,0,1106,2,2020-08-15,5202
"Carroll",383,4802,343,7,5185,33,2020-08-15,27887
"Chicot",919,3747,535,9,4666,375,2020-08-15,10826
"Clark",186,4103,167,2,4289,17,2020-08-15,22385
"Clay",145,2619,112,4,2764,29,2020-08-15,15061
"Cleburne",220,3800,182,5,4020,33,2020-08-15,25230
"Cleveland",117,1604,83,2,1721,32,2020-08-15,8226
"Columbia",241,3202,196,12,3443,33,2020-08-15,23892
"Conway",162,4069,138,3,4231,21,2020-08-15,20906
"Craighead",1473,18974,1274,13,20447,186,2020-08-15,105701
"Crawford",711,11452,571,5,12163,135,2020-08-15,62472
"Crittenden",1460,10683,1285,24,12143,151,2020-08-15,49013
"Cross",222,2667,184,4,2889,34,2020-08-15,16998
"Dallas",68,1188,58,2,1256,8,2020-08-15,7432
"Desha",210,2640,163,2,2850,45,2020-08-15,11887
"Drew",254,3978,180,3,4232,71,2020-08-15,18502
"Faulkner",1375,23548,1238,6,24923,131,2020-08-15,122416
"Franklin",139,3553,117,2,3692,20,2020-08-15,17780
"Fulton",47,711,30,0,758,17,2020-08-15,12139
"Garland",1169,18791,912,17,19960,240,2020-08-15,98298
"Grant",148,3075,129,0,3223,19,2020-08-15,18086
"Greene",531,8043,438,3,8574,90,2020-08-15,44623
"Hempstead",265,3085,227,2,3350,36,2020-08-15,22018
"Hot Spring",1621,7575,1465,13,9196,143,2020-08-15,33520
"Howard",367,2691,309,4,3058,54,2020-08-15,13389
"Independence",604,6199,439,2,6803,163,2020-08-15,37264
"Izard",62,1425,49,1,1487,12,2020-08-15,13559
"Jackson",124,2725,62,1,2849,61,2020-08-15,17225
"Jefferson",1670,16304,1372,41,17974,257,2020-08-15,70424
"Johnson",687,4967,648,2,5654,37,2020-08-15,26291
"Lafayette",59,714,52,2,773,5,2020-08-15,6915
"Lawrence",229,2185,199,9,2414,21,2020-08-15,16669
"Lee",901,3031,878,8,3932,15,2020-08-15,9398
"Lincoln",1290,3965,1189,12,5255,89,2020-08-15,13695
"Little River",215,1323,172,3,1538,40,2020-08-15,12417
"Logan",334,4669,190,1,5003,143,2020-08-15,21757
"Lonoke",564,10524,461,2,11088,101,2020-08-15,72206
"Madison",277,2831,267,2,3108,8,2020-08-15,16078
"Marion",33,1424,27,0,1457,6,2020-08-15,16438
"Miller",536,3990,492,5,4526,39,2020-08-15,43759
"Mississippi",1133,8143,874,14,9276,245,2020-08-15,42831
"Monroe",73,1461,55,0,1534,18,2020-08-15,7249
"Montgomery",42,1039,28,1,1081,13,2020-08-15,8993
"Nevada",147,2022,126,9,2169,12,2020-08-15,8440
"Newton",107,1017,88,11,1124,8,2020-08-15,7848
"Ouachita",113,3652,85,3,3765,25,2020-08-15,24106
"Perry",55,1877,50,0,1932,5,2020-08-15,10322
"Phillips",346,4524,293,9,4870,44,2020-08-15,19034
"Pike",138,1508,89,1,1646,48,2020-08-15,10808
"Poinsett",336,4490,227,4,4826,105,2020-08-15,24054
"Polk",159,2681,133,1,2840,25,2020-08-15,20163
"Pope",1426,13790,1255,12,15216,159,2020-08-15,63644
"Prairie",108,1307,83,0,1415,25,2020-08-15,8244
"Pulaski",6000,79925,5094,88,85925,818,2020-08-15,393463
"Randolph",255,3254,203,11,3509,41,2020-08-15,17603
"Saline",1239,16774,966,8,18013,265,2020-08-15,118009
"Scott",77,1267,52,0,1344,25,2020-08-15,10442
"Searcy",34,1260,29,0,1294,5,2020-08-15,7923
"Sebastian",2401,26313,1955,22,28714,424,2020-08-15,127461
"Sevier",1053,5096,974,11,6149,68,2020-08-15,17193
"Sharp",127,2432,103,5,2559,19,2020-08-15,17043
"St. Francis",1236,7786,1155,3,9022,78,2020-08-15,26294
"Stone",84,1969,59,1,2053,24,2020-08-15,12446
"Union",553,6045,476,20,6598,57,2020-08-15,39732
"Van Buren",54,2543,48,2,2597,4,2020-08-15,16684
"Washington",6400,45639,6098,53,52039,249,2020-08-15,228529
"White",389,8938,296,3,9327,90,2020-08-15,78804
"Woodruff",24,1157,20,0,1181,4,2020-08-15,6660
"Yell",1085,6878,1031,17,7963,37,2020-08-15,21757
"Arkansas",243,2947,211,1,3190,31,2020-08-14,18124
"Ashley",342,3016,287,5,3358,50,2020-08-14,20537
"Baxter",81,3472,69,0,3553,12,2020-08-14,41219
"Benton",4879,57180,4636,43,62059,200,2020-08-14,258980
"Boone",223,4363,184,2,4586,37,2020-08-14,37288
"Bradley",213,2367,150,4,2580,59,2020-08-14,10948
"Calhoun",17,568,15,0,585,2,2020-08-14,5202
"Carroll",380,4428,340,7,4808,33,2020-08-14,27887
"Chicot",887,3107,534,9,3994,344,2020-08-14,10826
"Clark",185,2980,166,2,3165,17,2020-08-14,22385
"Clay",143,2468,111,4,2611,28,2020-08-14,15061
"Cleburne",210,3441,182,5,3651,23,2020-08-14,25230
"Cleveland",115,1397,83,2,1512,30,2020-08-14,8226
"Columbia",227,2702,187,12,2929,28,2020-08-14,23892
"Conway",161,3256,138,3,3417,20,2020-08-14,20906
"Craighead",1451,17634,1259,12,19085,180,2020-08-14,105701
"Crawford",695,9290,558,5,9985,132,2020-08-14,62472
"Crittenden",1455,9060,1278,24,10515,153,2020-08-14,49013
"Cross",220,2268,180,4,2488,36,2020-08-14,16998
"Dallas",67,941,57,1,1008,9,2020-08-14,7432
"Desha",207,1905,162,2,2112,43,2020-08-14,11887
"Drew",240,3236,180,3,3476,57,2020-08-14,18502
"Faulkner",1370,18140,1232,6,19510,132,2020-08-14,122416
"Franklin",138,3127,114,2,3265,22,2020-08-14,17780
"Fulton",47,1403,29,0,1450,18,2020-08-14,12139
"Garland",1155,14651,900,17,15806,238,2020-08-14,98298
"Grant",144,2322,129,0,2466,15,2020-08-14,18086
"Greene",526,7306,424,3,7832,99,2020-08-14,44623
"Hempstead",260,3022,226,2,3282,32,2020-08-14,22018
"Hot Spring",1599,5764,1461,13,7363,125,2020-08-14,33520
"Howard",364,2606,308,4,2970,52,2020-08-14,13389
"Independence",589,5001,416,2,5590,171,2020-08-14,37264
"Izard",64,1474,49,1,1538,14,2020-08-14,13559
"Jackson",120,3126,62,1,3246,57,2020-08-14,17225
"Jefferson",1657,15015,1355,41,16672,261,2020-08-14,70424
"Johnson",687,2985,645,2,3672,40,2020-08-14,26291
"Lafayette",59,577,52,2,636,5,2020-08-14,6915
"Lawrence",226,2385,194,9,2611,23,2020-08-14,16669
"Lee",901,2943,878,8,3844,15,2020-08-14,9398
"Lincoln",1228,3195,1182,12,4423,34,2020-08-14,13695
"Little River",196,1265,167,3,1461,26,2020-08-14,12417
"Logan",331,4105,179,1,4436,151,2020-08-14,21757
"Lonoke",556,8407,454,2,8963,100,2020-08-14,72206
"Madison",277,2627,265,2,2904,10,2020-08-14,16078
"Marion",33,1340,27,0,1373,6,2020-08-14,16438
"Miller",533,4196,486,5,4729,42,2020-08-14,43759
"Mississippi",1097,7323,858,14,8420,225,2020-08-14,42831
"Monroe",71,1388,54,0,1459,17,2020-08-14,7249
"Montgomery",40,935,29,1,975,10,2020-08-14,8993
"Nevada",146,1641,125,9,1787,12,2020-08-14,8440
"Newton",107,873,89,10,980,8,2020-08-14,7848
"Ouachita",111,3271,86,3,3382,22,2020-08-14,24106
"Perry",55,1508,50,0,1563,5,2020-08-14,10322
"Phillips",336,3928,288,9,4264,39,2020-08-14,19034
"Pike",130,2977,87,1,3107,42,2020-08-14,10808
"Poinsett",324,2793,219,4,3117,101,2020-08-14,24054
"Polk",157,2388,134,1,2545,22,2020-08-14,20163
"Pope",1401,10382,1241,11,11783,149,2020-08-14,63644
"Prairie",107,1148,78,0,1255,29,2020-08-14,8244
"Pulaski",5937,66791,5049,88,72728,800,2020-08-14,393463
"Randolph",252,2917,209,4,3169,39,2020-08-14,17603
"Saline",1184,17308,950,8,18492,226,2020-08-14,118009
"Scott",72,1127,47,0,1199,25,2020-08-14,10442
"Searcy",32,1147,29,0,1179,3,2020-08-14,7923
"Sebastian",2358,23228,1918,21,25586,419,2020-08-14,127461
"Sevier",1034,4605,969,11,5639,54,2020-08-14,17193
"Sharp",125,1880,103,5,2005,17,2020-08-14,17043
"St. Francis",1236,7304,1139,3,8540,94,2020-08-14,26294
"Stone",79,1794,58,1,1873,20,2020-08-14,12446
"Union",539,4581,465,20,5120,54,2020-08-14,39732
"Van Buren",53,1585,48,2,1638,3,2020-08-14,16684
"Washington",6394,25414,6085,53,31808,256,2020-08-14,228529
"White",370,6616,293,3,6986,74,2020-08-14,78804
"Woodruff",23,1099,20,0,1122,3,2020-08-14,6660
"Yell",1086,3838,1031,17,4924,38,2020-08-14,21757
"Arkansas",241,2937,205,1,3178,35,2020-08-13,18124
"Ashley",337,3000,271,5,3337,61,2020-08-13,20537
"Baxter",78,3468,64,0,3546,14,2020-08-13,41219
"Benton",4864,56870,4596,43,61734,225,2020-08-13,258980
"Boone",222,4339,175,2,4561,45,2020-08-13,37288
"Bradley",212,2348,147,4,2560,61,2020-08-13,10948
"Calhoun",17,561,13,0,578,4,2020-08-13,5202
"Carroll",380,4413,335,7,4793,38,2020-08-13,27887
"Chicot",746,3053,516,9,3799,221,2020-08-13,10826
"Clark",183,2960,161,1,3143,21,2020-08-13,22385
"Clay",140,2465,109,4,2605,27,2020-08-13,15061
"Cleburne",210,3433,181,5,3643,24,2020-08-13,25230
"Cleveland",115,1388,79,2,1503,34,2020-08-13,8226
"Columbia",226,2688,183,12,2914,31,2020-08-13,23892
"Conway",161,3216,136,3,3377,22,2020-08-13,20906
"Craighead",1445,17557,1229,12,19002,204,2020-08-13,105701
"Crawford",682,9219,547,5,9901,130,2020-08-13,62472
"Crittenden",1442,9030,1258,24,10472,160,2020-08-13,49013
"Cross",217,2243,172,4,2460,41,2020-08-13,16998
"Dallas",67,896,57,1,963,9,2020-08-13,7432
"Desha",206,1892,154,2,2098,50,2020-08-13,11887
"Drew",234,3225,172,3,3459,59,2020-08-13,18502
"Faulkner",1361,18001,1213,6,19362,142,2020-08-13,122416
"Franklin",136,3105,108,2,3241,26,2020-08-13,17780
"Fulton",44,1392,29,0,1436,15,2020-08-13,12139
"Garland",1134,14573,873,17,15707,244,2020-08-13,98298
"Grant",144,2300,129,0,2444,15,2020-08-13,18086
"Greene",523,7290,353,3,7813,167,2020-08-13,44623
"Hempstead",255,3005,221,2,3260,32,2020-08-13,22018
"Hot Spring",1569,5685,1455,12,7254,102,2020-08-13,33520
"Howard",362,2593,303,4,2955,55,2020-08-13,13389
"Independence",584,4953,388,2,5537,194,2020-08-13,37264
"Izard",62,1458,45,1,1520,16,2020-08-13,13559
"Jackson",119,3119,59,1,3238,59,2020-08-13,17225
"Jefferson",1644,14510,1338,41,16154,265,2020-08-13,70424
"Johnson",679,2946,637,2,3625,40,2020-08-13,26291
"Lafayette",58,577,51,2,635,5,2020-08-13,6915
"Lawrence",223,2359,193,9,2582,21,2020-08-13,16669
"Lee",901,2936,877,8,3837,16,2020-08-13,9398
"Lincoln",1224,2832,1172,12,4056,40,2020-08-13,13695
"Little River",193,1244,164,2,1437,27,2020-08-13,12417
"Logan",321,3947,168,1,4268,152,2020-08-13,21757
"Lonoke",546,8355,448,2,8901,96,2020-08-13,72206
"Madison",275,2610,258,2,2885,15,2020-08-13,16078
"Marion",31,1332,26,0,1363,5,2020-08-13,16438
"Miller",527,4174,480,5,4701,42,2020-08-13,43759
"Mississippi",1089,7283,784,14,8372,291,2020-08-13,42831
"Monroe",65,1372,54,0,1437,11,2020-08-13,7249
"Montgomery",38,932,29,1,970,8,2020-08-13,8993
"Nevada",147,1635,124,9,1782,14,2020-08-13,8440
"Newton",107,870,88,10,977,9,2020-08-13,7848
"Ouachita",110,3228,83,2,3338,25,2020-08-13,24106
"Perry",55,1492,50,0,1547,5,2020-08-13,10322
"Phillips",334,3911,285,9,4245,40,2020-08-13,19034
"Pike",126,2953,84,1,3079,41,2020-08-13,10808
"Poinsett",319,2776,209,4,3095,106,2020-08-13,24054
"Polk",157,2366,134,1,2523,22,2020-08-13,20163
"Pope",1380,10307,1226,11,11687,143,2020-08-13,63644
"Prairie",104,1139,74,0,1243,30,2020-08-13,8244
"Pulaski",5880,66357,4987,88,72237,805,2020-08-13,393463
"Randolph",245,2905,198,4,3150,43,2020-08-13,17603
"Saline",1158,17095,924,8,18253,226,2020-08-13,118009
"Scott",70,1114,45,0,1184,25,2020-08-13,10442
"Searcy",32,1142,28,0,1174,4,2020-08-13,7923
"Sebastian",2344,23063,1862,21,25407,461,2020-08-13,127461
"Sevier",1017,4588,958,11,5605,48,2020-08-13,17193
"Sharp",120,1752,103,5,1872,12,2020-08-13,17043
"St. Francis",1231,7278,1133,3,8509,95,2020-08-13,26294
"Stone",76,1777,57,1,1853,18,2020-08-13,12446
"Union",532,4556,456,19,5088,57,2020-08-13,39732
"Van Buren",53,1579,48,2,1632,3,2020-08-13,16684
"Washington",6373,25134,6039,53,31507,281,2020-08-13,228529
"White",342,6526,287,3,6868,52,2020-08-13,78804
"Woodruff",22,1074,18,0,1096,4,2020-08-13,6660
"Yell",1084,3819,1021,17,4903,46,2020-08-13,21757
"Arkansas",233,2926,195,1,3159,37,2020-08-12,18124
"Ashley",335,2962,264,5,3297,66,2020-08-12,20537
"Baxter",76,3432,62,0,3508,14,2020-08-12,41219
"Benton",4825,56550,4547,43,61375,235,2020-08-12,258980
"Boone",217,4285,165,2,4502,50,2020-08-12,37288
"Bradley",207,2303,143,4,2510,60,2020-08-12,10948
"Calhoun",17,558,13,0,575,4,2020-08-12,5202
"Carroll",379,4367,332,7,4746,40,2020-08-12,27887
"Chicot",738,3033,509,9,3771,220,2020-08-12,10826
"Clark",182,2943,158,1,3125,23,2020-08-12,22385
"Clay",140,2449,109,4,2589,27,2020-08-12,15061
"Cleburne",206,3415,178,5,3621,23,2020-08-12,25230
"Cleveland",112,1367,76,2,1479,34,2020-08-12,8226
"Columbia",223,2680,179,12,2903,32,2020-08-12,23892
"Conway",156,3185,135,3,3341,18,2020-08-12,20906
"Craighead",1419,17463,1204,12,18882,203,2020-08-12,105701
"Crawford",668,9110,535,5,9778,128,2020-08-12,62472
"Crittenden",1402,8963,1231,24,10365,147,2020-08-12,49013
"Cross",212,2236,166,4,2448,42,2020-08-12,16998
"Dallas",65,887,55,1,952,9,2020-08-12,7432
"Desha",203,1875,147,2,2078,54,2020-08-12,11887
"Drew",221,3180,165,3,3401,53,2020-08-12,18502
"Faulkner",1340,17850,1201,6,19190,133,2020-08-12,122416
"Franklin",133,3093,102,2,3226,29,2020-08-12,17780
"Fulton",44,1371,29,0,1415,15,2020-08-12,12139
"Garland",1115,14406,854,17,15521,244,2020-08-12,98298
"Grant",142,2278,128,0,2420,14,2020-08-12,18086
"Greene",505,7217,337,2,7722,166,2020-08-12,44623
"Hempstead",253,2984,219,2,3237,32,2020-08-12,22018
"Hot Spring",1564,5663,1448,12,7227,104,2020-08-12,33520
"Howard",360,2586,299,4,2946,57,2020-08-12,13389
"Independence",568,4888,362,2,5456,204,2020-08-12,37264
"Izard",58,1447,44,1,1505,13,2020-08-12,13559
"Jackson",117,3103,56,1,3220,60,2020-08-12,17225
"Jefferson",1617,14088,1308,40,15705,269,2020-08-12,70424
"Johnson",676,2935,630,2,3611,44,2020-08-12,26291
"Lafayette",58,576,51,2,634,5,2020-08-12,6915
"Lawrence",221,2345,188,9,2566,24,2020-08-12,16669
"Lee",898,2917,875,8,3815,15,2020-08-12,9398
"Lincoln",1224,2822,1164,12,4046,48,2020-08-12,13695
"Little River",189,1239,161,1,1428,27,2020-08-12,12417
"Logan",323,3921,155,1,4244,167,2020-08-12,21757
"Lonoke",539,8246,439,2,8785,98,2020-08-12,72206
"Madison",271,2596,258,2,2867,11,2020-08-12,16078
"Marion",30,1319,22,0,1349,8,2020-08-12,16438
"Miller",519,4150,469,5,4669,45,2020-08-12,43759
"Mississippi",1068,7242,766,14,8310,288,2020-08-12,42831
"Monroe",64,1357,54,0,1421,10,2020-08-12,7249
"Montgomery",38,921,29,1,959,8,2020-08-12,8993
"Nevada",146,1630,123,9,1776,14,2020-08-12,8440
"Newton",106,862,88,10,968,8,2020-08-12,7848
"Ouachita",107,3214,82,2,3321,23,2020-08-12,24106
"Perry",55,1478,50,0,1533,5,2020-08-12,10322
"Phillips",332,3888,275,9,4220,48,2020-08-12,19034
"Pike",118,2933,81,1,3051,36,2020-08-12,10808
"Poinsett",308,2746,199,3,3054,106,2020-08-12,24054
"Polk",154,2338,132,1,2492,21,2020-08-12,20163
"Pope",1363,10268,1207,10,11631,146,2020-08-12,63644
"Prairie",102,1128,72,0,1230,30,2020-08-12,8244
"Pulaski",5787,65851,4901,87,71638,799,2020-08-12,393463
"Randolph",239,2870,193,4,3109,42,2020-08-12,17603
"Saline",1133,16927,902,7,18060,224,2020-08-12,118009
"Scott",68,1096,38,0,1164,30,2020-08-12,10442
"Searcy",32,1130,28,0,1162,4,2020-08-12,7923
"Sebastian",2297,22815,1801,21,25112,475,2020-08-12,127461
"Sevier",1009,4579,949,10,5588,50,2020-08-12,17193
"Sharp",117,1735,100,5,1852,12,2020-08-12,17043
"St. Francis",1228,7239,1118,3,8467,107,2020-08-12,26294
"Stone",74,1765,54,1,1839,19,2020-08-12,12446
"Union",523,4526,425,19,5049,79,2020-08-12,39732
"Van Buren",53,1572,48,2,1625,3,2020-08-12,16684
"Washington",6352,25030,5995,53,31382,304,2020-08-12,228529
"White",341,6491,279,2,6832,60,2020-08-12,78804
"Woodruff",22,1068,18,0,1090,4,2020-08-12,6660
"Yell",1077,3797,1013,17,4874,47,2020-08-12,21757
"Arkansas",227,2911,191,1,3138,35,2020-08-11,18124
"Ashley",330,2931,249,5,3261,76,2020-08-11,20537
"Baxter",73,3415,60,0,3488,13,2020-08-11,41219
"Benton",4805,56094,4505,43,60899,257,2020-08-11,258980
"Boone",214,4261,158,2,4475,54,2020-08-11,37288
"Bradley",207,2294,128,4,2501,75,2020-08-11,10948
"Calhoun",17,557,13,0,574,4,2020-08-11,5202
"Carroll",379,4333,331,7,4712,41,2020-08-11,27887
"Chicot",736,3023,424,9,3759,303,2020-08-11,10826
"Clark",177,2925,157,1,3102,19,2020-08-11,22385
"Clay",138,2419,107,4,2557,27,2020-08-11,15061
"Cleburne",202,3392,177,5,3594,20,2020-08-11,25230
"Cleveland",103,1348,71,2,1451,30,2020-08-11,8226
"Columbia",220,2669,176,12,2889,32,2020-08-11,23892
"Conway",153,3094,131,3,3247,19,2020-08-11,20906
"Craighead",1389,17355,1168,12,18744,209,2020-08-11,105701
"Crawford",648,8993,528,4,9641,116,2020-08-11,62472
"Crittenden",1381,8549,1216,23,9930,142,2020-08-11,49013
"Cross",208,2222,161,4,2430,43,2020-08-11,16998
"Dallas",64,875,54,1,939,9,2020-08-11,7432
"Desha",201,1846,141,2,2047,58,2020-08-11,11887
"Drew",217,3150,157,3,3367,57,2020-08-11,18502
"Faulkner",1330,17717,1184,6,19047,140,2020-08-11,122416
"Franklin",128,3070,100,2,3198,26,2020-08-11,17780
"Fulton",44,1346,29,0,1390,15,2020-08-11,12139
"Garland",1071,14140,830,17,15211,224,2020-08-11,98298
"Grant",140,2260,127,0,2400,13,2020-08-11,18086
"Greene",492,7143,320,2,7635,170,2020-08-11,44623
"Hempstead",249,2960,216,2,3209,31,2020-08-11,22018
"Hot Spring",1557,5632,1432,12,7189,113,2020-08-11,33520
"Howard",355,2575,292,4,2930,59,2020-08-11,13389
"Independence",550,4835,340,1,5385,209,2020-08-11,37264
"Izard",53,1429,44,1,1482,8,2020-08-11,13559
"Jackson",117,3096,56,1,3213,60,2020-08-11,17225
"Jefferson",1584,13617,1280,40,15201,264,2020-08-11,70424
"Johnson",672,2924,623,2,3596,47,2020-08-11,26291
"Lafayette",56,569,51,2,625,3,2020-08-11,6915
"Lawrence",217,2336,183,9,2553,25,2020-08-11,16669
"Lee",896,2908,875,8,3804,13,2020-08-11,9398
"Lincoln",1224,2813,1159,12,4037,53,2020-08-11,13695
"Little River",185,1234,157,1,1419,27,2020-08-11,12417
"Logan",277,3807,143,1,4084,133,2020-08-11,21757
"Lonoke",531,8194,426,2,8725,103,2020-08-11,72206
"Madison",270,2577,257,2,2847,11,2020-08-11,16078
"Marion",29,1312,22,0,1341,7,2020-08-11,16438
"Miller",518,4123,458,5,4641,55,2020-08-11,43759
"Mississippi",1044,6976,736,14,8020,294,2020-08-11,42831
"Monroe",64,1340,53,0,1404,11,2020-08-11,7249
"Montgomery",38,915,29,1,953,8,2020-08-11,8993
"Nevada",143,1617,122,9,1760,12,2020-08-11,8440
"Newton",106,856,86,10,962,10,2020-08-11,7848
"Ouachita",105,3188,81,2,3293,22,2020-08-11,24106
"Perry",55,1458,49,0,1513,6,2020-08-11,10322
"Phillips",329,3872,271,9,4201,49,2020-08-11,19034
"Pike",111,2918,78,1,3029,32,2020-08-11,10808
"Poinsett",292,2723,189,3,3015,100,2020-08-11,24054
"Polk",150,2322,132,1,2472,17,2020-08-11,20163
"Pope",1333,10188,1190,10,11521,133,2020-08-11,63644
"Prairie",100,1116,64,0,1216,36,2020-08-11,8244
"Pulaski",5706,65214,4827,86,70920,793,2020-08-11,393463
"Randolph",222,2863,186,4,3085,32,2020-08-11,17603
"Saline",1113,16790,888,7,17903,218,2020-08-11,118009
"Scott",66,1076,36,0,1142,30,2020-08-11,10442
"Searcy",33,1128,28,0,1161,5,2020-08-11,7923
"Sebastian",2250,22435,1740,20,24685,490,2020-08-11,127461
"Sevier",996,4571,939,10,5567,47,2020-08-11,17193
"Sharp",114,1718,98,5,1832,11,2020-08-11,17043
"St. Francis",1226,7218,1112,3,8444,111,2020-08-11,26294
"Stone",69,1753,52,1,1822,16,2020-08-11,12446
"Union",508,4497,410,18,5005,80,2020-08-11,39732
"Van Buren",53,1565,47,2,1618,4,2020-08-11,16684
"Washington",6321,24865,5957,52,31186,312,2020-08-11,228529
"White",328,6363,269,2,6691,57,2020-08-11,78804
"Woodruff",22,1068,17,0,1090,5,2020-08-11,6660
"Yell",1069,3780,1001,17,4849,51,2020-08-11,21757
"Arkansas",221,2902,184,1,3123,36,2020-08-10,18124
"Ashley",330,2922,234,5,3252,91,2020-08-10,20537
"Baxter",71,3401,58,0,3472,13,2020-08-10,41219
"Benton",4794,55633,4461,43,60427,290,2020-08-10,258980
"Boone",212,4214,149,2,4426,61,2020-08-10,37288
"Bradley",204,2267,122,4,2471,78,2020-08-10,10948
"Calhoun",17,551,13,0,568,4,2020-08-10,5202
"Carroll",359,4216,331,7,4575,21,2020-08-10,27887
"Chicot",739,3014,345,8,3753,386,2020-08-10,10826
"Clark",177,2919,151,1,3096,25,2020-08-10,22385
"Clay",136,2414,106,4,2550,26,2020-08-10,15061
"Cleburne",202,3384,176,5,3586,21,2020-08-10,25230
"Cleveland",102,1345,64,2,1447,36,2020-08-10,8226
"Columbia",217,2663,170,12,2880,35,2020-08-10,23892
"Conway",153,3089,129,3,3242,21,2020-08-10,20906
"Craighead",1374,17294,1131,12,18668,231,2020-08-10,105701
"Crawford",635,8927,516,4,9562,115,2020-08-10,62472
"Crittenden",1369,8395,1192,23,9764,154,2020-08-10,49013
"Cross",204,2216,158,4,2420,42,2020-08-10,16998
"Dallas",64,873,54,0,937,10,2020-08-10,7432
"Desha",197,1837,137,2,2034,58,2020-08-10,11887
"Drew",209,3135,153,3,3344,53,2020-08-10,18502
"Faulkner",1319,17636,1168,6,18955,145,2020-08-10,122416
"Franklin",127,3051,93,2,3178,32,2020-08-10,17780
"Fulton",44,1342,28,0,1386,16,2020-08-10,12139
"Garland",1058,14115,802,16,15173,240,2020-08-10,98298
"Grant",137,2249,124,0,2386,13,2020-08-10,18086
"Greene",485,7129,299,2,7614,184,2020-08-10,44623
"Hempstead",247,2945,208,2,3192,37,2020-08-10,22018
"Hot Spring",1554,5622,1423,11,7176,120,2020-08-10,33520
"Howard",342,2511,285,4,2853,53,2020-08-10,13389
"Independence",537,4808,322,1,5345,214,2020-08-10,37264
"Izard",53,1425,42,1,1478,10,2020-08-10,13559
"Jackson",117,3084,55,1,3201,61,2020-08-10,17225
"Jefferson",1574,13557,1261,40,15131,273,2020-08-10,70424
"Johnson",670,2921,618,2,3591,50,2020-08-10,26291
"Lafayette",54,566,50,2,620,2,2020-08-10,6915
"Lawrence",214,2321,175,9,2535,30,2020-08-10,16669
"Lee",896,2898,873,8,3794,15,2020-08-10,9398
"Lincoln",1223,2809,1154,12,4032,57,2020-08-10,13695
"Little River",181,1234,114,1,1415,66,2020-08-10,12417
"Logan",273,3787,139,1,4060,133,2020-08-10,21757
"Lonoke",524,8128,410,2,8652,112,2020-08-10,72206
"Madison",270,2566,254,2,2836,14,2020-08-10,16078
"Marion",29,1309,21,0,1338,8,2020-08-10,16438
"Miller",518,4116,449,5,4634,64,2020-08-10,43759
"Mississippi",1033,6902,712,14,7935,307,2020-08-10,42831
"Monroe",62,1329,50,0,1391,12,2020-08-10,7249
"Montgomery",38,912,27,1,950,10,2020-08-10,8993
"Nevada",143,1615,120,9,1758,14,2020-08-10,8440
"Newton",106,849,87,6,955,13,2020-08-10,7848
"Ouachita",102,3165,80,2,3267,20,2020-08-10,24106
"Perry",54,1454,47,0,1508,7,2020-08-10,10322
"Phillips",325,3849,263,9,4174,53,2020-08-10,19034
"Pike",108,2903,76,1,3011,31,2020-08-10,10808
"Poinsett",286,2717,176,3,3003,107,2020-08-10,24054
"Polk",148,2313,131,1,2461,16,2020-08-10,20163
"Pope",1319,10155,1165,10,11474,144,2020-08-10,63644
"Prairie",96,1112,60,0,1208,36,2020-08-10,8244
"Pulaski",5639,64661,4749,85,70300,805,2020-08-10,393463
"Randolph",219,2847,169,4,3066,46,2020-08-10,17603
"Saline",1095,16661,870,6,17756,219,2020-08-10,118009
"Scott",61,1072,36,0,1133,25,2020-08-10,10442
"Searcy",32,1123,27,0,1155,5,2020-08-10,7923
"Sebastian",2229,22244,1685,20,24473,524,2020-08-10,127461
"Sevier",992,4569,931,10,5561,51,2020-08-10,17193
"Sharp",112,1713,92,5,1825,15,2020-08-10,17043
"St. Francis",1223,7205,1104,3,8428,116,2020-08-10,26294
"Stone",69,1750,51,1,1819,17,2020-08-10,12446
"Union",504,4480,396,18,4984,90,2020-08-10,39732
"Van Buren",53,1557,46,2,1610,5,2020-08-10,16684
"Washington",6310,24670,5917,51,30980,342,2020-08-10,228529
"White",326,6337,260,2,6663,64,2020-08-10,78804
"Woodruff",22,1066,17,0,1088,5,2020-08-10,6660
"Yell",1067,3775,993,17,4842,57,2020-08-10,21757
"Arkansas",217,2884,182,1,3101,34,2020-08-09,18124
"Ashley",326,2834,230,5,3160,91,2020-08-09,20537
"Baxter",71,3363,57,0,3434,14,2020-08-09,41219
"Benton",4774,55298,4422,43,60072,309,2020-08-09,258980
"Boone",211,4197,143,1,4408,67,2020-08-09,37288
"Bradley",190,2209,119,3,2399,68,2020-08-09,10948
"Calhoun",16,546,13,0,562,3,2020-08-09,5202
"Carroll",354,4195,326,7,4549,21,2020-08-09,27887
"Chicot",733,2996,338,8,3729,387,2020-08-09,10826
"Clark",177,2900,150,1,3077,26,2020-08-09,22385
"Clay",136,2406,104,4,2542,28,2020-08-09,15061
"Cleburne",200,3350,174,5,3550,21,2020-08-09,25230
"Cleveland",97,1316,60,2,1413,35,2020-08-09,8226
"Columbia",215,2648,169,11,2863,35,2020-08-09,23892
"Conway",152,3067,129,3,3219,20,2020-08-09,20906
"Craighead",1344,17142,1084,12,18486,248,2020-08-09,105701
"Crawford",627,8810,504,4,9437,119,2020-08-09,62472
"Crittenden",1356,8340,1177,23,9696,156,2020-08-09,49013
"Cross",195,2174,158,4,2369,33,2020-08-09,16998
"Dallas",63,852,51,0,915,12,2020-08-09,7432
"Desha",194,1814,136,2,2008,56,2020-08-09,11887
"Drew",203,3104,149,3,3307,51,2020-08-09,18502
"Faulkner",1304,17530,1145,6,18834,153,2020-08-09,122416
"Franklin",126,3017,92,2,3143,32,2020-08-09,17780
"Fulton",42,1331,27,0,1373,15,2020-08-09,12139
"Garland",1008,13922,785,14,14930,209,2020-08-09,98298
"Grant",136,2228,124,0,2364,12,2020-08-09,18086
"Greene",476,7084,284,1,7560,191,2020-08-09,44623
"Hempstead",239,2906,200,2,3145,37,2020-08-09,22018
"Hot Spring",1546,5537,1416,11,7083,119,2020-08-09,33520
"Howard",340,2499,272,4,2839,64,2020-08-09,13389
"Independence",517,4765,298,1,5282,218,2020-08-09,37264
"Izard",53,1418,40,1,1471,12,2020-08-09,13559
"Jackson",112,3063,55,1,3175,56,2020-08-09,17225
"Jefferson",1534,13332,1235,40,14866,259,2020-08-09,70424
"Johnson",668,2899,612,2,3567,54,2020-08-09,26291
"Lafayette",54,562,49,2,616,3,2020-08-09,6915
"Lawrence",212,2317,171,9,2529,32,2020-08-09,16669
"Lee",894,2886,870,8,3780,16,2020-08-09,9398
"Lincoln",1219,2778,1147,12,3997,60,2020-08-09,13695
"Little River",181,1226,110,1,1407,70,2020-08-09,12417
"Logan",261,3737,132,1,3998,128,2020-08-09,21757
"Lonoke",512,8025,401,2,8537,109,2020-08-09,72206
"Madison",270,2558,251,2,2828,17,2020-08-09,16078
"Marion",28,1283,21,0,1311,7,2020-08-09,16438
"Miller",512,4087,443,5,4599,64,2020-08-09,43759
"Mississippi",1014,6859,680,14,7873,320,2020-08-09,42831
"Monroe",60,1317,49,0,1377,11,2020-08-09,7249
"Montgomery",35,903,25,1,938,9,2020-08-09,8993
"Nevada",142,1596,120,9,1738,13,2020-08-09,8440
"Newton",103,843,85,6,946,12,2020-08-09,7848
"Ouachita",100,3123,74,2,3223,24,2020-08-09,24106
"Perry",54,1444,47,0,1498,7,2020-08-09,10322
"Phillips",318,3803,259,8,4121,51,2020-08-09,19034
"Pike",101,2878,74,1,2979,26,2020-08-09,10808
"Poinsett",272,2690,162,3,2962,107,2020-08-09,24054
"Polk",142,2283,128,1,2425,13,2020-08-09,20163
"Pope",1313,10067,1145,10,11380,158,2020-08-09,63644
"Prairie",91,1088,58,0,1179,33,2020-08-09,8244
"Pulaski",5582,63966,4682,85,69548,815,2020-08-09,393463
"Randolph",213,2829,169,3,3042,41,2020-08-09,17603
"Saline",1046,16315,850,6,17361,190,2020-08-09,118009
"Scott",61,1068,36,0,1129,25,2020-08-09,10442
"Searcy",30,1115,27,0,1145,3,2020-08-09,7923
"Sebastian",2176,21920,1640,20,24096,516,2020-08-09,127461
"Sevier",989,4553,926,10,5542,53,2020-08-09,17193
"Sharp",113,1697,91,5,1810,17,2020-08-09,17043
"St. Francis",1209,7154,1100,3,8363,106,2020-08-09,26294
"Stone",69,1743,51,1,1812,17,2020-08-09,12446
"Union",499,4439,389,17,4938,93,2020-08-09,39732
"Van Buren",53,1551,46,2,1604,5,2020-08-09,16684
"Washington",6298,24456,5867,52,30754,379,2020-08-09,228529
"White",322,6185,256,2,6507,64,2020-08-09,78804
"Woodruff",21,1054,17,0,1075,4,2020-08-09,6660
"Yell",1066,3759,986,14,4825,66,2020-08-09,21757
"Arkansas",212,2857,181,1,3069,30,2020-08-08,18124
"Ashley",322,2813,225,5,3135,92,2020-08-08,20537
"Baxter",71,3323,56,0,3394,15,2020-08-08,41219
"Benton",4755,54873,4395,43,59628,317,2020-08-08,258980
"Boone",208,4160,136,1,4368,71,2020-08-08,37288
"Bradley",186,2193,116,3,2379,67,2020-08-08,10948
"Calhoun",16,541,12,0,557,4,2020-08-08,5202
"Carroll",353,4171,323,7,4524,23,2020-08-08,27887
"Chicot",729,2979,327,8,3708,394,2020-08-08,10826
"Clark",177,2874,147,1,3051,29,2020-08-08,22385
"Clay",130,2353,103,4,2483,23,2020-08-08,15061
"Cleburne",194,3323,172,5,3517,17,2020-08-08,25230
"Cleveland",97,1308,59,2,1405,36,2020-08-08,8226
"Columbia",214,2621,169,9,2835,36,2020-08-08,23892
"Conway",150,3047,128,3,3197,19,2020-08-08,20906
"Craighead",1336,16987,1071,12,18323,253,2020-08-08,105701
"Crawford",620,8642,497,4,9262,119,2020-08-08,62472
"Crittenden",1351,8302,1174,21,9653,156,2020-08-08,49013
"Cross",195,2154,157,4,2349,34,2020-08-08,16998
"Dallas",61,844,50,0,905,11,2020-08-08,7432
"Desha",192,1783,135,2,1975,55,2020-08-08,11887
"Drew",198,3073,146,3,3271,49,2020-08-08,18502
"Faulkner",1290,17367,1136,6,18657,148,2020-08-08,122416
"Franklin",126,2994,91,2,3120,33,2020-08-08,17780
"Fulton",40,1304,27,0,1344,13,2020-08-08,12139
"Garland",992,13803,768,12,14795,212,2020-08-08,98298
"Grant",135,2213,122,0,2348,13,2020-08-08,18086
"Greene",473,6973,277,1,7446,195,2020-08-08,44623
"Hempstead",239,2868,194,2,3107,43,2020-08-08,22018
"Hot Spring",1530,5495,1414,11,7025,105,2020-08-08,33520
"Howard",336,2478,259,3,2814,74,2020-08-08,13389
"Independence",492,4648,280,1,5140,211,2020-08-08,37264
"Izard",52,1404,39,1,1456,12,2020-08-08,13559
"Jackson",109,2957,54,1,3066,54,2020-08-08,17225
"Jefferson",1519,13132,1217,40,14651,262,2020-08-08,70424
"Johnson",663,2882,607,2,3545,54,2020-08-08,26291
"Lafayette",53,557,48,2,610,3,2020-08-08,6915
"Lawrence",209,2273,170,9,2482,30,2020-08-08,16669
"Lee",893,2874,870,8,3767,15,2020-08-08,9398
"Lincoln",1212,2657,1147,12,3869,53,2020-08-08,13695
"Little River",180,1221,107,1,1401,72,2020-08-08,12417
"Logan",252,3686,126,1,3938,125,2020-08-08,21757
"Lonoke",508,7955,386,2,8463,120,2020-08-08,72206
"Madison",270,2543,250,2,2813,18,2020-08-08,16078
"Marion",25,1275,19,0,1300,6,2020-08-08,16438
"Miller",508,4072,439,5,4580,64,2020-08-08,43759
"Mississippi",982,6741,668,14,7723,300,2020-08-08,42831
"Monroe",58,1291,47,0,1349,11,2020-08-08,7249
"Montgomery",34,896,23,1,930,10,2020-08-08,8993
"Nevada",137,1586,119,9,1723,9,2020-08-08,8440
"Newton",102,833,85,6,935,11,2020-08-08,7848
"Ouachita",98,3080,70,2,3178,26,2020-08-08,24106
"Perry",50,1432,47,0,1482,3,2020-08-08,10322
"Phillips",311,3771,257,7,4082,47,2020-08-08,19034
"Pike",101,2864,74,1,2965,26,2020-08-08,10808
"Poinsett",269,2598,156,3,2867,110,2020-08-08,24054
"Polk",140,2258,127,1,2398,12,2020-08-08,20163
"Pope",1306,10027,1127,10,11333,169,2020-08-08,63644
"Prairie",90,1076,58,0,1166,32,2020-08-08,8244
"Pulaski",5480,63547,4631,85,69027,764,2020-08-08,393463
"Randolph",209,2784,168,3,2993,38,2020-08-08,17603
"Saline",1017,15812,838,6,16829,173,2020-08-08,118009
"Scott",58,1032,35,0,1090,23,2020-08-08,10442
"Searcy",29,1105,26,0,1134,3,2020-08-08,7923
"Sebastian",2133,21630,1592,20,23763,521,2020-08-08,127461
"Sevier",988,4545,923,10,5533,55,2020-08-08,17193
"Sharp",111,1658,91,5,1769,15,2020-08-08,17043
"St. Francis",1193,6938,1091,3,8131,99,2020-08-08,26294
"Stone",67,1726,49,1,1793,17,2020-08-08,12446
"Union",478,4333,381,17,4811,80,2020-08-08,39732
"Van Buren",53,1541,46,2,1594,5,2020-08-08,16684
"Washington",6268,24202,5838,51,30470,379,2020-08-08,228529
"White",318,6136,256,2,6454,60,2020-08-08,78804
"Woodruff",21,1048,17,0,1069,4,2020-08-08,6660
"Yell",1065,3738,981,14,4803,70,2020-08-08,21757
"Arkansas",210,2830,178,1,3040,31,2020-08-07,18124
"Ashley",304,2755,206,5,3059,93,2020-08-07,20537
"Baxter",69,3301,54,0,3370,15,2020-08-07,41219
"Benton",4698,54384,4349,41,59082,308,2020-08-07,258980
"Boone",201,4122,128,1,4323,72,2020-08-07,37288
"Bradley",179,2167,116,3,2346,60,2020-08-07,10948
"Calhoun",15,526,12,0,541,3,2020-08-07,5202
"Carroll",350,4132,322,7,4482,21,2020-08-07,27887
"Chicot",718,2964,317,8,3682,393,2020-08-07,10826
"Clark",177,2846,146,1,3023,30,2020-08-07,22385
"Clay",127,2335,101,4,2462,22,2020-08-07,15061
"Cleburne",194,3286,169,5,3480,20,2020-08-07,25230
"Cleveland",93,1300,58,2,1393,33,2020-08-07,8226
"Columbia",212,2598,168,8,2810,36,2020-08-07,23892
"Conway",147,3021,123,3,3168,21,2020-08-07,20906
"Craighead",1318,16822,1040,12,18140,266,2020-08-07,105701
"Crawford",597,8416,487,3,9013,107,2020-08-07,62472
"Crittenden",1327,8233,1162,20,9560,145,2020-08-07,49013
"Cross",190,2126,157,3,2316,30,2020-08-07,16998
"Dallas",61,830,49,0,891,12,2020-08-07,7432
"Desha",187,1747,135,2,1934,50,2020-08-07,11887
"Drew",186,3040,145,3,3226,38,2020-08-07,18502
"Faulkner",1278,17222,1125,6,18500,147,2020-08-07,122416
"Franklin",123,2945,86,2,3068,35,2020-08-07,17780
"Fulton",35,1286,27,0,1321,8,2020-08-07,12139
"Garland",964,13619,743,9,14583,212,2020-08-07,98298
"Grant",133,2196,113,0,2329,20,2020-08-07,18086
"Greene",459,6899,268,1,7358,190,2020-08-07,44623
"Hempstead",233,2850,190,2,3083,41,2020-08-07,22018
"Hot Spring",1496,5453,1408,11,6949,77,2020-08-07,33520
"Howard",327,2465,253,3,2792,71,2020-08-07,13389
"Independence",483,4620,259,1,5103,223,2020-08-07,37264
"Izard",50,1393,37,1,1443,12,2020-08-07,13559
"Jackson",77,2385,54,1,2462,22,2020-08-07,17225
"Jefferson",1484,13015,1192,40,14499,252,2020-08-07,70424
"Johnson",662,2873,601,2,3535,59,2020-08-07,26291
"Lafayette",52,556,47,2,608,3,2020-08-07,6915
"Lawrence",206,2262,164,9,2468,33,2020-08-07,16669
"Lee",893,2832,870,8,3725,15,2020-08-07,9398
"Lincoln",1209,2644,1144,11,3853,54,2020-08-07,13695
"Little River",168,1214,100,1,1382,67,2020-08-07,12417
"Logan",233,3642,125,1,3875,107,2020-08-07,21757
"Lonoke",495,7832,378,2,8327,115,2020-08-07,72206
"Madison",269,2525,250,2,2794,17,2020-08-07,16078
"Marion",25,1265,19,0,1290,6,2020-08-07,16438
"Miller",499,4041,434,5,4540,60,2020-08-07,43759
"Mississippi",958,6654,657,13,7612,288,2020-08-07,42831
"Monroe",58,1278,46,0,1336,12,2020-08-07,7249
"Montgomery",34,892,23,1,926,10,2020-08-07,8993
"Nevada",137,1574,117,9,1711,11,2020-08-07,8440
"Newton",104,832,79,6,936,19,2020-08-07,7848
"Ouachita",92,2937,67,2,3029,23,2020-08-07,24106
"Perry",50,1421,47,0,1471,3,2020-08-07,10322
"Phillips",303,3739,255,7,4042,41,2020-08-07,19034
"Pike",97,2840,72,1,2937,24,2020-08-07,10808
"Poinsett",240,2574,148,3,2814,89,2020-08-07,24054
"Polk",140,2236,127,1,2376,12,2020-08-07,20163
"Pope",1282,9943,1099,10,11225,173,2020-08-07,63644
"Prairie",87,1051,58,0,1138,29,2020-08-07,8244
"Pulaski",5407,62892,4554,83,68299,770,2020-08-07,393463
"Randolph",206,2772,163,3,2978,40,2020-08-07,17603
"Saline",999,15563,820,6,16562,173,2020-08-07,118009
"Scott",55,1004,35,0,1059,20,2020-08-07,10442
"Searcy",28,1102,25,0,1130,3,2020-08-07,7923
"Sebastian",2079,21251,1548,19,23330,512,2020-08-07,127461
"Sevier",976,4510,916,10,5486,50,2020-08-07,17193
"Sharp",109,1641,90,5,1750,14,2020-08-07,17043
"St. Francis",1186,6657,1065,3,7843,118,2020-08-07,26294
"Stone",64,1713,46,1,1777,17,2020-08-07,12446
"Union",472,4286,375,17,4758,80,2020-08-07,39732
"Van Buren",52,1534,45,2,1586,5,2020-08-07,16684
"Washington",6231,23966,5806,51,30197,374,2020-08-07,228529
"White",312,6107,245,2,6419,65,2020-08-07,78804
"Woodruff",21,1040,17,0,1061,4,2020-08-07,6660
"Yell",1062,3711,976,14,4773,72,2020-08-07,21757
"Arkansas",208,2780,176,1,2988,31,2020-08-06,18124
"Ashley",298,2726,191,5,3024,102,2020-08-06,20537
"Baxter",68,3276,54,0,3344,14,2020-08-06,41219
"Benton",4663,53954,4318,40,58617,305,2020-08-06,258980
"Boone",193,4088,121,1,4281,71,2020-08-06,37288
"Bradley",173,2147,115,3,2320,55,2020-08-06,10948
"Calhoun",13,518,12,0,531,1,2020-08-06,5202
"Carroll",350,4089,316,7,4439,27,2020-08-06,27887
"Chicot",707,2944,305,8,3651,394,2020-08-06,10826
"Clark",175,2830,140,1,3005,34,2020-08-06,22385
"Clay",118,2303,98,4,2421,16,2020-08-06,15061
"Cleburne",188,3244,168,5,3432,15,2020-08-06,25230
"Cleveland",87,1288,58,2,1375,27,2020-08-06,8226
"Columbia",209,2527,166,8,2736,35,2020-08-06,23892
"Conway",143,2964,119,3,3107,21,2020-08-06,20906
"Craighead",1264,16664,1022,12,17928,230,2020-08-06,105701
"Crawford",582,8253,458,3,8835,121,2020-08-06,62472
"Crittenden",1315,8139,1140,20,9454,155,2020-08-06,49013
"Cross",183,2094,153,3,2277,27,2020-08-06,16998
"Dallas",59,819,46,0,878,13,2020-08-06,7432
"Desha",179,1717,133,2,1896,44,2020-08-06,11887
"Drew",182,3003,141,3,3185,38,2020-08-06,18502
"Faulkner",1252,17024,1094,5,18276,153,2020-08-06,122416
"Franklin",119,2898,82,2,3017,35,2020-08-06,17780
"Fulton",30,1269,25,0,1299,5,2020-08-06,12139
"Garland",939,13429,721,8,14368,210,2020-08-06,98298
"Grant",131,2171,112,0,2302,19,2020-08-06,18086
"Greene",445,6733,259,1,7178,185,2020-08-06,44623
"Hempstead",227,2797,184,2,3024,41,2020-08-06,22018
"Hot Spring",1484,5383,1401,12,6867,71,2020-08-06,33520
"Howard",322,2446,251,3,2768,68,2020-08-06,13389
"Independence",443,4519,243,1,4962,199,2020-08-06,37264
"Izard",47,1361,35,1,1408,11,2020-08-06,13559
"Jackson",63,1812,50,1,1875,12,2020-08-06,17225
"Jefferson",1423,12863,1176,40,14286,207,2020-08-06,70424
"Johnson",652,2854,595,2,3506,55,2020-08-06,26291
"Lafayette",52,550,45,2,602,5,2020-08-06,6915
"Lawrence",205,2230,164,9,2435,32,2020-08-06,16669
"Lee",890,2814,867,8,3704,15,2020-08-06,9398
"Lincoln",1197,2601,1138,11,3798,48,2020-08-06,13695
"Little River",164,1209,94,1,1373,69,2020-08-06,12417
"Logan",225,3576,125,1,3801,99,2020-08-06,21757
"Lonoke",482,7716,365,2,8198,115,2020-08-06,72206
"Madison",269,2509,248,2,2778,19,2020-08-06,16078
"Marion",25,1257,19,0,1282,6,2020-08-06,16438
"Miller",495,4006,430,5,4501,60,2020-08-06,43759
"Mississippi",914,6591,634,13,7505,267,2020-08-06,42831
"Monroe",55,1267,43,0,1322,12,2020-08-06,7249
"Montgomery",34,887,23,1,921,10,2020-08-06,8993
"Nevada",136,1556,115,9,1692,12,2020-08-06,8440
"Newton",102,827,57,6,929,39,2020-08-06,7848
"Ouachita",84,2860,66,2,2944,16,2020-08-06,24106
"Perry",50,1411,47,0,1461,3,2020-08-06,10322
"Phillips",298,3683,247,7,3981,44,2020-08-06,19034
"Pike",91,2784,69,1,2875,21,2020-08-06,10808
"Poinsett",217,2553,137,3,2770,77,2020-08-06,24054
"Polk",137,2202,123,1,2339,13,2020-08-06,20163
"Pope",1276,9785,1074,10,11061,192,2020-08-06,63644
"Prairie",80,1025,55,0,1105,25,2020-08-06,8244
"Pulaski",5222,62153,4471,81,67375,670,2020-08-06,393463
"Randolph",199,2746,154,3,2945,42,2020-08-06,17603
"Saline",975,15345,799,6,16320,170,2020-08-06,118009
"Scott",51,985,33,0,1036,18,2020-08-06,10442
"Searcy",28,1097,25,0,1125,3,2020-08-06,7923
"Sebastian",2038,20895,1500,17,22933,521,2020-08-06,127461
"Sevier",969,4478,910,10,5447,49,2020-08-06,17193
"Sharp",107,1596,89,5,1703,13,2020-08-06,17043
"St. Francis",1165,6564,1029,3,7729,133,2020-08-06,26294
"Stone",61,1682,46,1,1743,14,2020-08-06,12446
"Union",464,4235,365,17,4699,82,2020-08-06,39732
"Van Buren",52,1523,45,2,1575,5,2020-08-06,16684
"Washington",6188,23746,5736,51,29934,401,2020-08-06,228529
"White",289,6037,229,2,6326,58,2020-08-06,78804
"Woodruff",20,1012,17,0,1032,3,2020-08-06,6660
"Yell",1055,3680,967,14,4735,74,2020-08-06,21757
"Arkansas",209,2762,171,1,2971,37,2020-08-05,18124
"Ashley",284,2657,178,5,2941,101,2020-08-05,20537
"Baxter",68,3251,52,0,3319,16,2020-08-05,41219
"Benton",4634,53456,4265,40,58090,329,2020-08-05,258980
"Boone",184,4049,115,1,4233,68,2020-08-05,37288
"Bradley",167,2119,112,3,2286,52,2020-08-05,10948
"Calhoun",13,513,11,0,526,2,2020-08-05,5202
"Carroll",346,4063,314,7,4409,25,2020-08-05,27887
"Chicot",700,2886,299,8,3586,393,2020-08-05,10826
"Clark",170,2685,136,1,2855,33,2020-08-05,22385
"Clay",114,2278,98,4,2392,12,2020-08-05,15061
"Cleburne",187,3230,167,5,3417,15,2020-08-05,25230
"Cleveland",83,1277,55,2,1360,26,2020-08-05,8226
"Columbia",209,2513,165,7,2722,37,2020-08-05,23892
"Conway",143,2916,119,3,3059,21,2020-08-05,20906
"Craighead",1196,16560,1007,12,17756,177,2020-08-05,105701
"Crawford",569,8150,448,3,8719,118,2020-08-05,62472
"Crittenden",1291,8076,1126,20,9367,145,2020-08-05,49013
"Cross",173,2088,150,3,2261,20,2020-08-05,16998
"Dallas",59,812,44,0,871,15,2020-08-05,7432
"Desha",174,1704,132,2,1878,40,2020-08-05,11887
"Drew",175,2942,138,3,3117,34,2020-08-05,18502
"Faulkner",1239,16897,1077,5,18136,157,2020-08-05,122416
"Franklin",113,2867,80,2,2980,31,2020-08-05,17780
"Fulton",30,1259,25,0,1289,5,2020-08-05,12139
"Garland",910,13269,693,8,14179,209,2020-08-05,98298
"Grant",130,2152,110,0,2282,20,2020-08-05,18086
"Greene",422,6600,258,1,7022,163,2020-08-05,44623
"Hempstead",227,2784,179,2,3011,46,2020-08-05,22018
"Hot Spring",1479,5292,1396,12,6771,71,2020-08-05,33520
"Howard",308,2415,245,2,2723,61,2020-08-05,13389
"Independence",433,4451,222,1,4884,210,2020-08-05,37264
"Izard",45,1353,34,1,1398,10,2020-08-05,13559
"Jackson",62,1805,48,1,1867,13,2020-08-05,17225
"Jefferson",1412,12759,1148,40,14171,224,2020-08-05,70424
"Johnson",646,2835,590,2,3481,54,2020-08-05,26291
"Lafayette",52,541,43,2,593,7,2020-08-05,6915
"Lawrence",191,2227,162,9,2418,20,2020-08-05,16669
"Lee",890,2805,867,8,3695,15,2020-08-05,9398
"Lincoln",1196,2591,1138,11,3787,47,2020-08-05,13695
"Little River",160,1205,89,1,1365,70,2020-08-05,12417
"Logan",208,3478,125,1,3686,82,2020-08-05,21757
"Lonoke",474,7675,350,2,8149,122,2020-08-05,72206
"Madison",267,2485,248,1,2752,18,2020-08-05,16078
"Marion",26,1253,19,0,1279,7,2020-08-05,16438
"Miller",489,3980,426,5,4469,58,2020-08-05,43759
"Mississippi",891,6551,612,12,7442,267,2020-08-05,42831
"Monroe",52,1256,40,0,1308,12,2020-08-05,7249
"Montgomery",31,869,23,0,900,8,2020-08-05,8993
"Nevada",134,1554,115,9,1688,10,2020-08-05,8440
"Newton",100,823,28,5,923,67,2020-08-05,7848
"Ouachita",84,2837,64,2,2921,18,2020-08-05,24106
"Perry",50,1404,47,0,1454,3,2020-08-05,10322
"Phillips",298,3666,242,7,3964,49,2020-08-05,19034
"Pike",88,2719,67,1,2807,20,2020-08-05,10808
"Poinsett",190,2543,129,3,2733,58,2020-08-05,24054
"Polk",134,2189,120,1,2323,13,2020-08-05,20163
"Pope",1266,9728,1048,10,10994,208,2020-08-05,63644
"Prairie",78,1018,53,0,1096,25,2020-08-05,8244
"Pulaski",5151,61490,4371,81,66641,699,2020-08-05,393463
"Randolph",198,2731,151,3,2929,44,2020-08-05,17603
"Saline",949,15176,775,6,16125,168,2020-08-05,118009
"Scott",46,967,33,0,1013,13,2020-08-05,10442
"Searcy",28,1091,23,0,1119,5,2020-08-05,7923
"Sebastian",1977,20561,1464,17,22538,496,2020-08-05,127461
"Sevier",958,4455,904,10,5413,44,2020-08-05,17193
"Sharp",106,1581,85,5,1687,16,2020-08-05,17043
"St. Francis",1148,6463,1019,3,7611,126,2020-08-05,26294
"Stone",59,1665,45,1,1724,13,2020-08-05,12446
"Union",458,4198,359,17,4656,82,2020-08-05,39732
"Van Buren",52,1522,45,2,1574,5,2020-08-05,16684
"Washington",6168,23597,5681,50,29765,437,2020-08-05,228529
"White",284,6022,228,2,6306,54,2020-08-05,78804
"Woodruff",20,1012,17,0,1032,3,2020-08-05,6660
"Yell",1052,3651,956,14,4703,82,2020-08-05,21757
"Arkansas",206,2716,165,1,2922,40,2020-08-04,18124
"Ashley",262,2622,163,4,2884,95,2020-08-04,20537
"Baxter",64,3239,50,0,3303,14,2020-08-04,41219
"Benton",4611,53041,4202,40,57652,369,2020-08-04,258980
"Boone",184,4031,106,1,4215,77,2020-08-04,37288
"Bradley",155,2064,112,3,2219,40,2020-08-04,10948
"Calhoun",13,508,10,0,521,3,2020-08-04,5202
"Carroll",341,4031,309,7,4372,25,2020-08-04,27887
"Chicot",552,2698,285,7,3250,260,2020-08-04,10826
"Clark",164,2654,134,1,2818,29,2020-08-04,22385
"Clay",112,2258,93,4,2370,15,2020-08-04,15061
"Cleburne",183,3208,161,5,3391,17,2020-08-04,25230
"Cleveland",76,1257,53,2,1333,21,2020-08-04,8226
"Columbia",207,2491,162,7,2698,38,2020-08-04,23892
"Conway",138,2876,119,3,3014,16,2020-08-04,20906
"Craighead",1156,16435,981,12,17591,163,2020-08-04,105701
"Crawford",566,8078,437,3,8644,126,2020-08-04,62472
"Crittenden",1269,8026,1094,20,9295,155,2020-08-04,49013
"Cross",172,2082,149,2,2254,21,2020-08-04,16998
"Dallas",59,803,39,0,862,20,2020-08-04,7432
"Desha",165,1690,126,2,1855,37,2020-08-04,11887
"Drew",171,2919,132,3,3090,36,2020-08-04,18502
"Faulkner",1229,16702,1063,5,17931,161,2020-08-04,122416
"Franklin",111,2841,76,2,2952,33,2020-08-04,17780
"Fulton",29,1247,25,0,1276,4,2020-08-04,12139
"Garland",879,13073,674,8,13952,197,2020-08-04,98298
"Grant",130,2133,106,0,2263,24,2020-08-04,18086
"Greene",403,6557,239,1,6960,163,2020-08-04,44623
"Hempstead",224,2762,177,2,2986,45,2020-08-04,22018
"Hot Spring",1475,5249,1393,10,6724,72,2020-08-04,33520
"Howard",303,2408,241,2,2711,60,2020-08-04,13389
"Independence",413,4433,189,1,4846,223,2020-08-04,37264
"Izard",45,1344,32,1,1389,12,2020-08-04,13559
"Jackson",61,1796,48,1,1857,12,2020-08-04,17225
"Jefferson",1404,12687,1121,39,14091,244,2020-08-04,70424
"Johnson",639,2823,573,0,3462,66,2020-08-04,26291
"Lafayette",50,538,42,2,588,6,2020-08-04,6915
"Lawrence",186,2202,155,10,2388,21,2020-08-04,16669
"Lee",890,2795,867,7,3685,16,2020-08-04,9398
"Lincoln",1195,2578,1130,11,3773,54,2020-08-04,13695
"Little River",158,1199,87,1,1357,70,2020-08-04,12417
"Logan",196,3383,120,1,3579,75,2020-08-04,21757
"Lonoke",469,7578,341,2,8047,126,2020-08-04,72206
"Madison",265,2470,245,1,2735,19,2020-08-04,16078
"Marion",24,1247,18,0,1271,6,2020-08-04,16438
"Miller",475,3971,415,4,4446,56,2020-08-04,43759
"Mississippi",853,6460,584,11,7313,258,2020-08-04,42831
"Monroe",53,1249,38,0,1302,15,2020-08-04,7249
"Montgomery",29,857,23,0,886,6,2020-08-04,8993
"Nevada",134,1545,115,9,1679,10,2020-08-04,8440
"Newton",100,816,25,3,916,72,2020-08-04,7848
"Ouachita",81,2818,63,2,2899,16,2020-08-04,24106
"Perry",49,1387,47,0,1436,2,2020-08-04,10322
"Phillips",289,3635,240,7,3924,42,2020-08-04,19034
"Pike",84,2689,65,1,2773,18,2020-08-04,10808
"Poinsett",173,2522,124,3,2695,46,2020-08-04,24054
"Polk",132,2182,116,1,2314,15,2020-08-04,20163
"Pope",1241,9653,1021,10,10894,210,2020-08-04,63644
"Prairie",76,1009,52,0,1085,24,2020-08-04,8244
"Pulaski",5054,60987,4264,79,66041,711,2020-08-04,393463
"Randolph",178,2695,148,3,2873,27,2020-08-04,17603
"Saline",922,15032,751,6,15954,165,2020-08-04,118009
"Scott",45,957,32,0,1002,13,2020-08-04,10442
"Searcy",27,1081,22,0,1108,5,2020-08-04,7923
"Sebastian",1919,20349,1415,15,22268,489,2020-08-04,127461
"Sevier",944,4452,899,10,5396,35,2020-08-04,17193
"Sharp",106,1571,83,5,1677,18,2020-08-04,17043
"St. Francis",1144,6441,999,3,7585,142,2020-08-04,26294
"Stone",59,1657,40,1,1716,18,2020-08-04,12446
"Union",452,4171,353,17,4623,82,2020-08-04,39732
"Van Buren",52,1513,42,2,1565,8,2020-08-04,16684
"Washington",6120,23216,5611,48,29336,461,2020-08-04,228529
"White",271,5992,220,2,6263,49,2020-08-04,78804
"Woodruff",20,1012,17,0,1032,3,2020-08-04,6660
"Yell",1043,3610,947,14,4653,82,2020-08-04,21757
"Arkansas",201,2621,162,0,2822,39,2020-08-03,18124
"Ashley",254,2567,160,4,2821,90,2020-08-03,20537
"Baxter",62,3222,48,0,3284,14,2020-08-03,41219
"Benton",4572,52174,4151,39,56746,382,2020-08-03,258980
"Boone",176,3903,100,1,4079,75,2020-08-03,37288
"Bradley",147,1817,112,3,1964,32,2020-08-03,10948
"Calhoun",13,504,10,0,517,3,2020-08-03,5202
"Carroll",340,3975,301,6,4315,33,2020-08-03,27887
"Chicot",536,2595,278,6,3131,252,2020-08-03,10826
"Clark",159,2604,131,0,2763,28,2020-08-03,22385
"Clay",109,2236,92,4,2345,13,2020-08-03,15061
"Cleburne",182,3190,161,5,3372,16,2020-08-03,25230
"Cleveland",71,1231,52,2,1302,17,2020-08-03,8226
"Columbia",202,2457,155,6,2659,41,2020-08-03,23892
"Conway",137,2849,119,3,2986,15,2020-08-03,20906
"Craighead",1134,16140,951,12,17274,171,2020-08-03,105701
"Crawford",554,7893,418,3,8447,133,2020-08-03,62472
"Crittenden",1242,7954,1074,20,9196,148,2020-08-03,49013
"Cross",172,2075,146,2,2247,24,2020-08-03,16998
"Dallas",58,794,38,0,852,20,2020-08-03,7432
"Desha",160,1662,124,2,1822,34,2020-08-03,11887
"Drew",166,2795,123,2,2961,41,2020-08-03,18502
"Faulkner",1212,16569,1040,5,17781,167,2020-08-03,122416
"Franklin",108,2805,76,2,2913,30,2020-08-03,17780
"Fulton",29,1235,25,0,1264,4,2020-08-03,12139
"Garland",875,13028,640,8,13903,227,2020-08-03,98298
"Grant",127,2117,99,0,2244,28,2020-08-03,18086
"Greene",393,6438,225,1,6831,167,2020-08-03,44623
"Hempstead",220,2743,172,2,2963,46,2020-08-03,22018
"Hot Spring",1465,5219,1379,9,6684,77,2020-08-03,33520
"Howard",300,2405,231,2,2705,67,2020-08-03,13389
"Independence",398,4407,177,0,4805,221,2020-08-03,37264
"Izard",45,1341,31,1,1386,13,2020-08-03,13559
"Jackson",59,1773,47,1,1832,11,2020-08-03,17225
"Jefferson",1382,12599,1100,39,13981,243,2020-08-03,70424
"Johnson",636,2815,567,0,3451,69,2020-08-03,26291
"Lafayette",49,536,41,2,585,6,2020-08-03,6915
"Lawrence",185,2187,154,10,2372,21,2020-08-03,16669
"Lee",890,2783,865,7,3673,18,2020-08-03,9398
"Lincoln",1186,2562,1127,11,3748,48,2020-08-03,13695
"Little River",156,1193,85,1,1349,70,2020-08-03,12417
"Logan",195,3328,119,1,3523,75,2020-08-03,21757
"Lonoke",452,7453,331,2,7905,119,2020-08-03,72206
"Madison",262,2447,243,1,2709,18,2020-08-03,16078
"Marion",23,1235,18,0,1258,5,2020-08-03,16438
"Miller",470,3956,398,4,4426,68,2020-08-03,43759
"Mississippi",797,6336,557,11,7133,229,2020-08-03,42831
"Monroe",53,1230,38,0,1283,15,2020-08-03,7249
"Montgomery",26,848,22,0,874,4,2020-08-03,8993
"Nevada",133,1535,115,9,1668,9,2020-08-03,8440
"Newton",98,810,22,3,908,73,2020-08-03,7848
"Ouachita",81,2799,61,1,2880,19,2020-08-03,24106
"Perry",49,1375,47,0,1424,2,2020-08-03,10322
"Phillips",284,3576,234,6,3860,44,2020-08-03,19034
"Pike",81,2653,60,1,2734,20,2020-08-03,10808
"Poinsett",167,2504,120,3,2671,44,2020-08-03,24054
"Polk",131,2164,113,1,2295,17,2020-08-03,20163
"Pope",1216,9558,986,9,10774,221,2020-08-03,63644
"Prairie",74,982,53,0,1056,21,2020-08-03,8244
"Pulaski",4893,60483,4172,79,65376,642,2020-08-03,393463
"Randolph",175,2680,136,3,2855,36,2020-08-03,17603
"Saline",892,14853,729,5,15745,158,2020-08-03,118009
"Scott",44,945,31,0,989,13,2020-08-03,10442
"Searcy",27,1073,22,0,1100,5,2020-08-03,7923
"Sebastian",1856,20074,1357,15,21930,484,2020-08-03,127461
"Sevier",939,4449,894,10,5388,35,2020-08-03,17193
"Sharp",106,1558,83,5,1664,18,2020-08-03,17043
"St. Francis",1140,6413,994,3,7553,143,2020-08-03,26294
"Stone",55,1648,38,1,1703,16,2020-08-03,12446
"Union",435,4143,346,16,4578,73,2020-08-03,39732
"Van Buren",52,1499,42,2,1551,8,2020-08-03,16684
"Washington",6072,22923,5548,47,28995,477,2020-08-03,228529
"White",266,5956,208,2,6222,56,2020-08-03,78804
"Woodruff",20,1010,17,0,1030,3,2020-08-03,6660
"Yell",1030,3592,941,14,4622,75,2020-08-03,21757
"Arkansas",199,2600,156,0,2799,43,2020-08-02,18124
"Ashley",249,2517,154,4,2766,91,2020-08-02,20537
"Baxter",61,3192,48,0,3253,13,2020-08-02,41219
"Benton",4528,51247,4099,39,55775,390,2020-08-02,258980
"Boone",170,3830,95,1,4000,74,2020-08-02,37288
"Bradley",142,1791,107,3,1933,32,2020-08-02,10948
"Calhoun",13,500,10,0,513,3,2020-08-02,5202
"Carroll",340,3917,296,6,4257,38,2020-08-02,27887
"Chicot",529,2573,275,6,3102,248,2020-08-02,10826
"Clark",154,2571,127,0,2725,27,2020-08-02,22385
"Clay",107,2209,92,4,2316,11,2020-08-02,15061
"Cleburne",181,3152,156,5,3333,20,2020-08-02,25230
"Cleveland",68,1218,51,2,1286,15,2020-08-02,8226
"Columbia",193,2339,153,6,2532,34,2020-08-02,23892
"Conway",136,2795,119,3,2931,14,2020-08-02,20906
"Craighead",1120,15959,932,11,17079,177,2020-08-02,105701
"Crawford",536,7709,411,3,8245,122,2020-08-02,62472
"Crittenden",1213,7836,1056,20,9049,137,2020-08-02,49013
"Cross",166,2038,142,1,2204,23,2020-08-02,16998
"Dallas",58,788,39,0,846,19,2020-08-02,7432
"Desha",151,1643,124,2,1794,25,2020-08-02,11887
"Drew",162,2727,122,2,2889,38,2020-08-02,18502
"Faulkner",1203,16420,1024,5,17623,174,2020-08-02,122416
"Franklin",108,2746,68,2,2854,38,2020-08-02,17780
"Fulton",29,1223,24,0,1252,5,2020-08-02,12139
"Garland",843,12785,614,7,13628,222,2020-08-02,98298
"Grant",125,2076,95,0,2201,30,2020-08-02,18086
"Greene",383,6276,217,1,6659,165,2020-08-02,44623
"Hempstead",210,2676,165,2,2886,43,2020-08-02,22018
"Hot Spring",1457,5151,1378,8,6608,71,2020-08-02,33520
"Howard",296,2374,223,2,2670,71,2020-08-02,13389
"Independence",367,4320,162,0,4687,205,2020-08-02,37264
"Izard",44,1320,30,1,1364,13,2020-08-02,13559
"Jackson",58,1748,46,1,1806,11,2020-08-02,17225
"Jefferson",1357,12394,1086,38,13751,233,2020-08-02,70424
"Johnson",631,2801,548,0,3432,83,2020-08-02,26291
"Lafayette",49,531,40,2,580,7,2020-08-02,6915
"Lawrence",185,2162,152,10,2347,23,2020-08-02,16669
"Lee",885,2746,864,6,3631,15,2020-08-02,9398
"Lincoln",1182,2535,1120,11,3717,51,2020-08-02,13695
"Little River",153,1186,81,1,1339,71,2020-08-02,12417
"Logan",158,3191,117,1,3349,40,2020-08-02,21757
"Lonoke",433,7323,325,2,7756,106,2020-08-02,72206
"Madison",259,2418,243,1,2677,15,2020-08-02,16078
"Marion",23,1229,17,0,1252,6,2020-08-02,16438
"Miller",462,3909,388,4,4371,70,2020-08-02,43759
"Mississippi",775,6225,534,10,7000,231,2020-08-02,42831
"Monroe",52,1215,37,0,1267,15,2020-08-02,7249
"Montgomery",25,834,19,0,859,6,2020-08-02,8993
"Nevada",130,1517,113,9,1647,8,2020-08-02,8440
"Newton",94,791,21,3,885,70,2020-08-02,7848
"Ouachita",77,2762,60,1,2839,16,2020-08-02,24106
"Perry",49,1362,47,0,1411,2,2020-08-02,10322
"Phillips",282,3555,232,6,3837,44,2020-08-02,19034
"Pike",78,2629,59,1,2707,18,2020-08-02,10808
"Poinsett",159,2479,115,3,2638,41,2020-08-02,24054
"Polk",128,2137,111,1,2265,16,2020-08-02,20163
"Pope",1202,9450,962,9,10652,231,2020-08-02,63644
"Prairie",66,943,53,0,1009,13,2020-08-02,8244
"Pulaski",4838,59865,4089,78,64703,671,2020-08-02,393463
"Randolph",173,2626,134,2,2799,37,2020-08-02,17603
"Saline",879,14679,708,4,15558,167,2020-08-02,118009
"Scott",42,923,28,0,965,14,2020-08-02,10442
"Searcy",25,1062,22,0,1087,3,2020-08-02,7923
"Sebastian",1768,19438,1318,15,21206,435,2020-08-02,127461
"Sevier",935,4409,891,10,5344,34,2020-08-02,17193
"Sharp",104,1533,78,5,1637,21,2020-08-02,17043
"St. Francis",1131,6239,987,3,7370,141,2020-08-02,26294
"Stone",53,1632,37,1,1685,15,2020-08-02,12446
"Union",433,4106,343,16,4539,74,2020-08-02,39732
"Van Buren",50,1491,41,2,1541,7,2020-08-02,16684
"Washington",6005,22457,5489,46,28462,470,2020-08-02,228529
"White",262,5903,199,2,6165,61,2020-08-02,78804
"Woodruff",19,990,17,0,1009,2,2020-08-02,6660
"Yell",1022,3580,935,14,4602,73,2020-08-02,21757
"Arkansas",194,2483,154,0,2677,40,2020-08-01,18124
"Ashley",238,2490,154,4,2728,80,2020-08-01,20537
"Baxter",60,3160,47,0,3220,13,2020-08-01,41219
"Benton",4495,50815,4061,39,55310,395,2020-08-01,258980
"Boone",162,3764,89,1,3926,72,2020-08-01,37288
"Bradley",142,1766,106,3,1908,33,2020-08-01,10948
"Calhoun",13,494,9,0,507,4,2020-08-01,5202
"Carroll",337,3871,285,6,4208,46,2020-08-01,27887
"Chicot",522,2552,266,6,3074,250,2020-08-01,10826
"Clark",152,2544,123,0,2696,29,2020-08-01,22385
"Clay",105,2183,91,4,2288,10,2020-08-01,15061
"Cleburne",179,3117,155,5,3296,19,2020-08-01,25230
"Cleveland",67,1177,49,2,1244,16,2020-08-01,8226
"Columbia",186,2295,152,6,2481,28,2020-08-01,23892
"Conway",134,2746,118,3,2880,13,2020-08-01,20906
"Craighead",1104,15839,910,11,16943,183,2020-08-01,105701
"Crawford",522,7617,401,3,8139,118,2020-08-01,62472
"Crittenden",1191,7734,1048,18,8925,124,2020-08-01,49013
"Cross",162,2019,138,1,2181,23,2020-08-01,16998
"Dallas",56,773,38,0,829,18,2020-08-01,7432
"Desha",144,1596,117,2,1740,25,2020-08-01,11887
"Drew",155,2678,119,2,2833,34,2020-08-01,18502
"Faulkner",1190,16283,1016,5,17473,169,2020-08-01,122416
"Franklin",105,2695,63,2,2800,40,2020-08-01,17780
"Fulton",27,1213,24,0,1240,3,2020-08-01,12139
"Garland",837,12649,590,7,13486,240,2020-08-01,98298
"Grant",124,2056,91,0,2180,33,2020-08-01,18086
"Greene",359,6143,213,1,6502,145,2020-08-01,44623
"Hempstead",207,2652,159,2,2859,46,2020-08-01,22018
"Hot Spring",1451,5080,1370,8,6531,73,2020-08-01,33520
"Howard",294,2363,219,2,2657,73,2020-08-01,13389
"Independence",345,4259,154,0,4604,191,2020-08-01,37264
"Izard",44,1313,30,1,1357,13,2020-08-01,13559
"Jackson",58,1731,43,1,1789,14,2020-08-01,17225
"Jefferson",1315,12249,1056,38,13564,221,2020-08-01,70424
"Johnson",617,2763,544,0,3380,73,2020-08-01,26291
"Lafayette",49,525,40,2,574,7,2020-08-01,6915
"Lawrence",182,2134,149,9,2316,24,2020-08-01,16669
"Lee",885,2729,861,6,3614,18,2020-08-01,9398
"Lincoln",1168,2507,1115,11,3675,42,2020-08-01,13695
"Little River",152,1182,75,1,1334,76,2020-08-01,12417
"Logan",141,3165,117,0,3306,24,2020-08-01,21757
"Lonoke",416,7258,321,2,7674,93,2020-08-01,72206
"Madison",254,2408,242,1,2662,11,2020-08-01,16078
"Marion",23,1218,17,0,1241,6,2020-08-01,16438
"Miller",457,3872,384,4,4329,69,2020-08-01,43759
"Mississippi",752,6138,510,10,6890,232,2020-08-01,42831
"Monroe",51,1202,36,0,1253,15,2020-08-01,7249
"Montgomery",25,829,19,0,854,6,2020-08-01,8993
"Nevada",129,1510,113,9,1639,7,2020-08-01,8440
"Newton",93,779,19,3,872,71,2020-08-01,7848
"Ouachita",76,2748,58,1,2824,17,2020-08-01,24106
"Perry",49,1352,47,0,1401,2,2020-08-01,10322
"Phillips",273,3507,226,6,3780,41,2020-08-01,19034
"Pike",77,2612,58,1,2689,18,2020-08-01,10808
"Poinsett",156,2445,110,3,2601,43,2020-08-01,24054
"Polk",128,2101,109,1,2229,18,2020-08-01,20163
"Pope",1174,9307,935,9,10481,230,2020-08-01,63644
"Prairie",63,931,52,0,994,11,2020-08-01,8244
"Pulaski",4803,59432,4048,77,64235,677,2020-08-01,393463
"Randolph",170,2597,130,2,2767,38,2020-08-01,17603
"Saline",868,14559,691,4,15427,173,2020-08-01,118009
"Scott",41,907,28,0,948,13,2020-08-01,10442
"Searcy",25,1048,22,0,1073,3,2020-08-01,7923
"Sebastian",1724,19176,1277,14,20900,433,2020-08-01,127461
"Sevier",933,4401,886,10,5334,37,2020-08-01,17193
"Sharp",102,1518,76,5,1620,21,2020-08-01,17043
"St. Francis",1117,6149,977,3,7266,137,2020-08-01,26294
"Stone",52,1618,37,1,1670,14,2020-08-01,12446
"Union",430,4057,338,16,4487,76,2020-08-01,39732
"Van Buren",50,1486,39,2,1536,9,2020-08-01,16684
"Washington",5952,22205,5443,46,28157,463,2020-08-01,228529
"White",254,5853,192,2,6107,60,2020-08-01,78804
"Woodruff",19,983,17,0,1002,2,2020-08-01,6660
"Yell",1012,3554,927,14,4566,71,2020-08-01,21757
"Arkansas",189,2421,145,1,2610,43,2020-07-31,18124
"Ashley",230,2456,146,4,2686,80,2020-07-31,20537
"Baxter",62,3146,49,0,3208,13,2020-07-31,41219
"Benton",4458,50557,4021,38,55015,399,2020-07-31,258980
"Boone",157,3616,88,1,3773,68,2020-07-31,37288
"Bradley",138,1748,105,3,1886,30,2020-07-31,10948
"Calhoun",12,487,9,0,499,3,2020-07-31,5202
"Carroll",331,3836,278,6,4167,47,2020-07-31,27887
"Chicot",506,2464,260,6,2970,240,2020-07-31,10826
"Clark",152,2534,119,0,2686,33,2020-07-31,22385
"Clay",102,2158,90,4,2260,8,2020-07-31,15061
"Cleburne",178,3078,155,5,3256,18,2020-07-31,25230
"Cleveland",63,1068,49,1,1131,13,2020-07-31,8226
"Columbia",184,2286,149,6,2470,29,2020-07-31,23892
"Conway",134,2718,118,3,2852,13,2020-07-31,20906
"Craighead",1088,15698,888,11,16786,189,2020-07-31,105701
"Crawford",514,7492,397,3,8006,114,2020-07-31,62472
"Crittenden",1172,7654,1039,17,8826,116,2020-07-31,49013
"Cross",157,2011,135,1,2168,21,2020-07-31,16998
"Dallas",56,760,38,0,816,18,2020-07-31,7432
"Desha",142,1580,113,2,1722,27,2020-07-31,11887
"Drew",155,2667,117,2,2822,36,2020-07-31,18502
"Faulkner",1175,16064,992,5,17239,178,2020-07-31,122416
"Franklin",104,2641,54,2,2745,48,2020-07-31,17780
"Fulton",27,1206,21,0,1233,6,2020-07-31,12139
"Garland",814,12513,563,7,13327,244,2020-07-31,98298
"Grant",124,2032,87,0,2156,37,2020-07-31,18086
"Greene",293,5868,205,1,6161,87,2020-07-31,44623
"Hempstead",200,2624,148,2,2824,50,2020-07-31,22018
"Hot Spring",1436,5032,1367,8,6468,61,2020-07-31,33520
"Howard",291,2352,216,2,2643,73,2020-07-31,13389
"Independence",331,4228,146,0,4559,185,2020-07-31,37264
"Izard",43,1310,30,1,1353,12,2020-07-31,13559
"Jackson",57,1716,43,1,1773,13,2020-07-31,17225
"Jefferson",1293,12030,1017,37,13323,239,2020-07-31,70424
"Johnson",612,2732,535,0,3344,77,2020-07-31,26291
"Lafayette",48,519,39,2,567,7,2020-07-31,6915
"Lawrence",179,2120,149,9,2299,21,2020-07-31,16669
"Lee",882,2709,861,6,3591,15,2020-07-31,9398
"Lincoln",1165,2481,1114,11,3646,40,2020-07-31,13695
"Little River",149,1173,73,1,1322,75,2020-07-31,12417
"Logan",139,3148,116,0,3287,23,2020-07-31,21757
"Lonoke",405,7185,304,2,7590,99,2020-07-31,72206
"Madison",253,2401,237,1,2654,15,2020-07-31,16078
"Marion",23,1212,17,0,1235,6,2020-07-31,16438
"Miller",451,3765,379,4,4216,68,2020-07-31,43759
"Mississippi",677,5964,488,9,6641,180,2020-07-31,42831
"Monroe",49,1182,35,0,1231,14,2020-07-31,7249
"Montgomery",25,825,19,0,850,6,2020-07-31,8993
"Nevada",129,1502,113,9,1631,7,2020-07-31,8440
"Newton",91,770,19,3,861,69,2020-07-31,7848
"Ouachita",75,2720,54,1,2795,20,2020-07-31,24106
"Perry",49,1338,45,0,1387,4,2020-07-31,10322
"Phillips",270,3479,224,6,3749,40,2020-07-31,19034
"Pike",77,2594,55,1,2671,21,2020-07-31,10808
"Poinsett",151,2407,107,3,2558,41,2020-07-31,24054
"Polk",125,2077,107,1,2202,17,2020-07-31,20163
"Pope",1161,9233,920,9,10394,232,2020-07-31,63644
"Prairie",59,920,50,0,979,9,2020-07-31,8244
"Pulaski",4733,58745,3947,77,63478,709,2020-07-31,393463
"Randolph",164,2582,120,2,2746,42,2020-07-31,17603
"Saline",855,14327,678,4,15182,173,2020-07-31,118009
"Scott",41,900,28,0,941,13,2020-07-31,10442
"Searcy",25,1042,22,0,1067,3,2020-07-31,7923
"Sebastian",1689,18907,1240,14,20596,435,2020-07-31,127461
"Sevier",929,4384,875,10,5313,44,2020-07-31,17193
"Sharp",99,1506,76,5,1605,18,2020-07-31,17043
"St. Francis",1112,6104,971,3,7216,138,2020-07-31,26294
"Stone",52,1617,37,1,1669,14,2020-07-31,12446
"Union",428,4038,334,16,4466,78,2020-07-31,39732
"Van Buren",50,1474,39,2,1524,9,2020-07-31,16684
"Washington",5896,22018,5396,45,27914,455,2020-07-31,228529
"White",250,5802,184,2,6052,64,2020-07-31,78804
"Woodruff",18,980,17,0,998,1,2020-07-31,6660
"Yell",1004,3532,925,14,4536,65,2020-07-31,21757
"Arkansas",183,2342,138,1,2525,44,2020-07-30,18124
"Ashley",214,2398,138,4,2612,72,2020-07-30,20537
"Baxter",61,3122,45,0,3183,16,2020-07-30,41219
"Benton",4408,50097,3975,35,54505,398,2020-07-30,258980
"Boone",142,3589,85,1,3731,56,2020-07-30,37288
"Bradley",134,1726,99,3,1860,32,2020-07-30,10948
"Calhoun",12,482,8,0,494,4,2020-07-30,5202
"Carroll",331,3796,270,6,4127,55,2020-07-30,27887
"Chicot",498,2454,256,5,2952,237,2020-07-30,10826
"Clark",153,2502,117,0,2655,36,2020-07-30,22385
"Clay",103,2145,89,4,2248,10,2020-07-30,15061
"Cleburne",175,3024,155,5,3199,15,2020-07-30,25230
"Cleveland",63,1051,48,1,1114,14,2020-07-30,8226
"Columbia",178,2252,138,6,2430,34,2020-07-30,23892
"Conway",133,2678,116,3,2811,14,2020-07-30,20906
"Craighead",1062,15568,862,11,16630,189,2020-07-30,105701
"Crawford",495,7356,386,3,7851,106,2020-07-30,62472
"Crittenden",1135,7602,1019,17,8737,99,2020-07-30,49013
"Cross",157,1997,128,1,2154,28,2020-07-30,16998
"Dallas",55,752,38,0,807,17,2020-07-30,7432
"Desha",138,1565,105,2,1703,31,2020-07-30,11887
"Drew",152,2621,114,2,2773,36,2020-07-30,18502
"Faulkner",1158,15820,973,5,16978,180,2020-07-30,122416
"Franklin",101,2621,52,2,2722,47,2020-07-30,17780
"Fulton",26,1188,21,0,1214,5,2020-07-30,12139
"Garland",786,12230,541,7,13016,238,2020-07-30,98298
"Grant",122,2004,85,0,2126,37,2020-07-30,18086
"Greene",280,5802,192,1,6082,87,2020-07-30,44623
"Hempstead",192,2553,141,2,2745,49,2020-07-30,22018
"Hot Spring",1429,4942,1346,7,6371,76,2020-07-30,33520
"Howard",287,2325,205,2,2612,80,2020-07-30,13389
"Independence",299,4145,133,0,4444,166,2020-07-30,37264
"Izard",38,1288,30,1,1326,7,2020-07-30,13559
"Jackson",56,1692,43,1,1748,12,2020-07-30,17225
"Jefferson",1270,11864,993,37,13134,240,2020-07-30,70424
"Johnson",606,2782,528,0,3388,78,2020-07-30,26291
"Lafayette",48,510,38,2,558,8,2020-07-30,6915
"Lawrence",173,2097,146,9,2270,18,2020-07-30,16669
"Lee",879,2676,857,6,3555,16,2020-07-30,9398
"Lincoln",1161,2445,1113,11,3606,37,2020-07-30,13695
"Little River",145,1162,73,1,1307,71,2020-07-30,12417
"Logan",134,3111,112,0,3245,22,2020-07-30,21757
"Lonoke",393,7134,291,2,7527,100,2020-07-30,72206
"Madison",253,2387,235,1,2640,17,2020-07-30,16078
"Marion",22,1201,17,0,1223,5,2020-07-30,16438
"Miller",442,3631,373,4,4073,65,2020-07-30,43759
"Mississippi",648,5879,470,8,6527,170,2020-07-30,42831
"Monroe",48,1153,33,0,1201,15,2020-07-30,7249
"Montgomery",24,815,19,0,839,5,2020-07-30,8993
"Nevada",128,1488,112,9,1616,7,2020-07-30,8440
"Newton",89,763,18,3,852,68,2020-07-30,7848
"Ouachita",74,2678,53,1,2752,20,2020-07-30,24106
"Perry",48,1322,43,0,1370,5,2020-07-30,10322
"Phillips",265,3390,216,6,3655,43,2020-07-30,19034
"Pike",69,2563,47,1,2632,21,2020-07-30,10808
"Poinsett",141,2401,102,3,2542,36,2020-07-30,24054
"Polk",125,2047,107,0,2172,18,2020-07-30,20163
"Pope",1150,9260,901,8,10410,241,2020-07-30,63644
"Prairie",57,905,49,0,962,8,2020-07-30,8244
"Pulaski",4654,57961,3865,76,62615,713,2020-07-30,393463
"Randolph",155,2563,114,2,2718,39,2020-07-30,17603
"Saline",827,14024,661,4,14851,162,2020-07-30,118009
"Scott",35,877,27,0,912,8,2020-07-30,10442
"Searcy",25,1029,22,0,1054,3,2020-07-30,7923
"Sebastian",1601,18508,1196,14,20109,391,2020-07-30,127461
"Sevier",927,4337,867,10,5264,50,2020-07-30,17193
"Sharp",97,1493,74,5,1590,18,2020-07-30,17043
"St. Francis",1104,6012,963,3,7116,138,2020-07-30,26294
"Stone",50,1559,36,1,1609,13,2020-07-30,12446
"Union",396,3980,328,16,4376,52,2020-07-30,39732
"Van Buren",50,1459,39,2,1509,9,2020-07-30,16684
"Washington",5855,21713,5346,43,27568,466,2020-07-30,228529
"White",243,5717,181,2,5960,60,2020-07-30,78804
"Woodruff",17,969,17,0,986,0,2020-07-30,6660
"Yell",991,3598,917,14,4589,60,2020-07-30,21757
"Arkansas",181,2321,123,1,2502,57,2020-07-29,18124
"Ashley",197,2320,134,4,2517,59,2020-07-29,20537
"Baxter",56,3084,44,0,3140,12,2020-07-29,41219
"Benton",4355,49564,3926,35,53919,394,2020-07-29,258980
"Boone",130,3539,82,1,3669,47,2020-07-29,37288
"Bradley",123,1635,96,3,1758,24,2020-07-29,10948
"Calhoun",10,471,7,0,481,3,2020-07-29,5202
"Carroll",331,3773,264,6,4104,61,2020-07-29,27887
"Chicot",483,2437,252,4,2920,227,2020-07-29,10826
"Clark",148,2473,111,0,2621,37,2020-07-29,22385
"Clay",104,2116,89,4,2220,11,2020-07-29,15061
"Cleburne",175,2966,152,5,3141,18,2020-07-29,25230
"Cleveland",63,1038,47,1,1101,15,2020-07-29,8226
"Columbia",172,2227,134,6,2399,32,2020-07-29,23892
"Conway",129,2635,111,3,2764,15,2020-07-29,20906
"Craighead",1031,15322,827,11,16353,193,2020-07-29,105701
"Crawford",487,7270,368,3,7757,116,2020-07-29,62472
"Crittenden",1127,7542,1005,17,8669,105,2020-07-29,49013
"Cross",156,1979,124,1,2135,31,2020-07-29,16998
"Dallas",51,739,22,0,790,29,2020-07-29,7432
"Desha",136,1548,101,2,1684,33,2020-07-29,11887
"Drew",149,2585,113,2,2734,34,2020-07-29,18502
"Faulkner",1138,15599,944,4,16737,190,2020-07-29,122416
"Franklin",96,2396,44,2,2492,50,2020-07-29,17780
"Fulton",26,1178,21,0,1204,5,2020-07-29,12139
"Garland",735,11915,509,7,12650,219,2020-07-29,98298
"Grant",122,1977,82,0,2099,40,2020-07-29,18086
"Greene",269,5670,187,1,5939,81,2020-07-29,44623
"Hempstead",190,2523,132,2,2713,56,2020-07-29,22018
"Hot Spring",1419,4883,1333,7,6302,79,2020-07-29,33520
"Howard",282,2293,193,2,2575,87,2020-07-29,13389
"Independence",266,4092,123,0,4358,143,2020-07-29,37264
"Izard",37,1267,29,1,1304,7,2020-07-29,13559
"Jackson",55,1680,43,1,1735,11,2020-07-29,17225
"Jefferson",1239,11660,960,37,12899,242,2020-07-29,70424
"Johnson",597,2754,522,0,3351,75,2020-07-29,26291
"Lafayette",48,503,35,2,551,11,2020-07-29,6915
"Lawrence",169,2079,141,9,2248,19,2020-07-29,16669
"Lee",878,2666,855,6,3544,17,2020-07-29,9398
"Lincoln",1155,2424,1075,11,3579,69,2020-07-29,13695
"Little River",138,1148,68,1,1286,69,2020-07-29,12417
"Logan",130,3081,111,0,3211,19,2020-07-29,21757
"Lonoke",383,7059,286,2,7442,95,2020-07-29,72206
"Madison",246,2366,233,1,2612,12,2020-07-29,16078
"Marion",21,1177,17,0,1198,4,2020-07-29,16438
"Miller",438,3602,359,4,4040,75,2020-07-29,43759
"Mississippi",625,5790,446,8,6415,171,2020-07-29,42831
"Monroe",48,1137,31,0,1185,17,2020-07-29,7249
"Montgomery",24,814,19,0,838,5,2020-07-29,8993
"Nevada",128,1479,113,8,1607,7,2020-07-29,8440
"Newton",90,754,18,0,844,72,2020-07-29,7848
"Ouachita",72,2597,50,1,2669,21,2020-07-29,24106
"Perry",46,1306,42,0,1352,4,2020-07-29,10322
"Phillips",260,3378,213,6,3638,41,2020-07-29,19034
"Pike",65,2517,47,1,2582,17,2020-07-29,10808
"Poinsett",133,2352,96,3,2485,34,2020-07-29,24054
"Polk",124,2017,106,0,2141,18,2020-07-29,20163
"Pope",1119,9158,873,8,10277,238,2020-07-29,63644
"Prairie",57,893,49,0,950,8,2020-07-29,8244
"Pulaski",4575,57087,3787,75,61662,713,2020-07-29,393463
"Randolph",152,2533,112,2,2685,38,2020-07-29,17603
"Saline",809,13809,640,4,14618,165,2020-07-29,118009
"Scott",34,861,26,0,895,8,2020-07-29,10442
"Searcy",25,1023,20,0,1048,5,2020-07-29,7923
"Sebastian",1543,18000,1166,13,19543,364,2020-07-29,127461
"Sevier",918,4307,853,10,5225,55,2020-07-29,17193
"Sharp",94,1474,72,5,1568,17,2020-07-29,17043
"St. Francis",1086,5888,957,3,6974,126,2020-07-29,26294
"Stone",45,1523,36,1,1568,8,2020-07-29,12446
"Union",379,3857,320,16,4236,43,2020-07-29,39732
"Van Buren",49,1439,39,2,1488,8,2020-07-29,16684
"Washington",5812,21549,5269,43,27361,500,2020-07-29,228529
"White",241,5622,180,2,5863,59,2020-07-29,78804
"Woodruff",17,958,17,0,975,0,2020-07-29,6660
"Yell",982,3571,905,14,4553,63,2020-07-29,21757
"Arkansas",172,2287,112,1,2459,59,2020-07-28,18124
"Ashley",187,2275,130,4,2462,53,2020-07-28,20537
"Baxter",56,3069,43,0,3125,13,2020-07-28,41219
"Benton",4321,49168,3874,35,53489,412,2020-07-28,258980
"Boone",126,3500,78,1,3626,47,2020-07-28,37288
"Bradley",122,1632,94,3,1754,25,2020-07-28,10948
"Calhoun",10,469,6,0,479,4,2020-07-28,5202
"Carroll",328,3739,259,6,4067,63,2020-07-28,27887
"Chicot",331,1944,242,4,2275,85,2020-07-28,10826
"Clark",145,2454,105,0,2599,40,2020-07-28,22385
"Clay",103,2104,88,4,2207,11,2020-07-28,15061
"Cleburne",175,2950,152,5,3125,18,2020-07-28,25230
"Cleveland",62,1032,43,1,1094,18,2020-07-28,8226
"Columbia",169,2217,130,6,2386,33,2020-07-28,23892
"Conway",124,2609,108,3,2733,13,2020-07-28,20906
"Craighead",1006,15195,785,11,16201,210,2020-07-28,105701
"Crawford",473,7153,344,3,7626,126,2020-07-28,62472
"Crittenden",1113,7523,981,17,8636,115,2020-07-28,49013
"Cross",155,1964,118,1,2119,36,2020-07-28,16998
"Dallas",49,730,16,0,779,33,2020-07-28,7432
"Desha",133,1528,96,2,1661,35,2020-07-28,11887
"Drew",146,2546,107,2,2692,37,2020-07-28,18502
"Faulkner",1120,15348,923,4,16468,193,2020-07-28,122416
"Franklin",85,2340,43,2,2425,40,2020-07-28,17780
"Fulton",26,1164,20,0,1190,6,2020-07-28,12139
"Garland",713,11778,482,7,12491,224,2020-07-28,98298
"Grant",118,1955,82,0,2073,36,2020-07-28,18086
"Greene",247,5604,181,1,5851,65,2020-07-28,44623
"Hempstead",180,2499,126,2,2679,52,2020-07-28,22018
"Hot Spring",1411,4846,1321,7,6257,83,2020-07-28,33520
"Howard",275,2271,190,2,2546,83,2020-07-28,13389
"Independence",259,4045,112,0,4304,147,2020-07-28,37264
"Izard",35,1255,28,1,1290,6,2020-07-28,13559
"Jackson",55,1674,44,1,1729,10,2020-07-28,17225
"Jefferson",1222,11570,945,36,12792,241,2020-07-28,70424
"Johnson",592,2735,512,0,3327,80,2020-07-28,26291
"Lafayette",48,498,32,2,546,14,2020-07-28,6915
"Lawrence",162,2063,135,9,2225,18,2020-07-28,16669
"Lee",876,2654,852,6,3530,18,2020-07-28,9398
"Lincoln",1155,2409,1047,11,3564,97,2020-07-28,13695
"Little River",106,1109,65,1,1215,40,2020-07-28,12417
"Logan",129,3053,105,0,3182,24,2020-07-28,21757
"Lonoke",368,6984,272,2,7352,94,2020-07-28,72206
"Madison",246,2356,232,1,2602,13,2020-07-28,16078
"Marion",18,1168,17,0,1186,1,2020-07-28,16438
"Miller",428,3570,348,4,3998,76,2020-07-28,43759
"Mississippi",603,5741,437,8,6344,158,2020-07-28,42831
"Monroe",48,1132,31,0,1180,17,2020-07-28,7249
"Montgomery",23,809,18,0,832,5,2020-07-28,8993
"Nevada",127,1472,111,8,1599,8,2020-07-28,8440
"Newton",89,738,17,0,827,72,2020-07-28,7848
"Ouachita",71,2580,48,1,2651,22,2020-07-28,24106
"Perry",45,1293,41,0,1338,4,2020-07-28,10322
"Phillips",256,3321,209,6,3577,41,2020-07-28,19034
"Pike",60,2492,42,1,2552,17,2020-07-28,10808
"Poinsett",130,2329,93,3,2459,34,2020-07-28,24054
"Polk",123,1997,107,0,2120,16,2020-07-28,20163
"Pope",1110,9067,860,6,10177,244,2020-07-28,63644
"Prairie",56,887,49,0,943,7,2020-07-28,8244
"Pulaski",4492,56269,3676,74,60761,742,2020-07-28,393463
"Randolph",145,2507,110,2,2652,33,2020-07-28,17603
"Saline",798,13627,616,4,14425,178,2020-07-28,118009
"Scott",33,850,21,0,883,12,2020-07-28,10442
"Searcy",23,1011,20,0,1034,3,2020-07-28,7923
"Sebastian",1499,17753,1122,13,19252,364,2020-07-28,127461
"Sevier",913,4274,849,10,5187,54,2020-07-28,17193
"Sharp",89,1453,71,5,1542,13,2020-07-28,17043
"St. Francis",1083,5792,953,3,6875,127,2020-07-28,26294
"Stone",44,1514,34,1,1558,9,2020-07-28,12446
"Union",376,3849,314,15,4225,47,2020-07-28,39732
"Van Buren",46,1434,38,2,1480,6,2020-07-28,16684
"Washington",5783,21348,5201,42,27131,540,2020-07-28,228529
"White",230,5518,177,2,5748,51,2020-07-28,78804
"Woodruff",17,958,16,0,975,1,2020-07-28,6660
"Yell",975,3554,898,14,4529,63,2020-07-28,21757
"Arkansas",168,2276,104,1,2444,63,2020-07-27,18124
"Ashley",187,2263,126,4,2450,57,2020-07-27,20537
"Baxter",56,3058,43,0,3114,13,2020-07-27,41219
"Benton",4263,48740,3810,35,53003,418,2020-07-27,258980
"Boone",118,3484,72,1,3602,45,2020-07-27,37288
"Bradley",120,1626,87,2,1746,31,2020-07-27,10948
"Calhoun",9,469,5,0,478,4,2020-07-27,5202
"Carroll",325,3691,258,6,4016,61,2020-07-27,27887
"Chicot",325,1934,239,4,2259,82,2020-07-27,10826
"Clark",138,2443,101,0,2581,37,2020-07-27,22385
"Clay",103,2082,86,4,2185,13,2020-07-27,15061
"Cleburne",175,2938,149,5,3113,21,2020-07-27,25230
"Cleveland",61,1019,41,1,1080,19,2020-07-27,8226
"Columbia",166,2214,129,5,2380,32,2020-07-27,23892
"Conway",122,2584,105,3,2706,14,2020-07-27,20906
"Craighead",969,14993,757,9,15962,203,2020-07-27,105701
"Crawford",464,7038,330,3,7502,131,2020-07-27,62472
"Crittenden",1100,7426,967,16,8526,117,2020-07-27,49013
"Cross",151,1925,110,1,2076,40,2020-07-27,16998
"Dallas",48,725,16,0,773,32,2020-07-27,7432
"Desha",129,1520,89,1,1649,39,2020-07-27,11887
"Drew",143,2537,106,2,2680,35,2020-07-27,18502
"Faulkner",1081,15177,890,4,16258,187,2020-07-27,122416
"Franklin",83,2293,41,1,2376,41,2020-07-27,17780
"Fulton",23,1157,19,0,1180,4,2020-07-27,12139
"Garland",695,11704,457,5,12399,233,2020-07-27,98298
"Grant",115,1935,80,0,2050,35,2020-07-27,18086
"Greene",230,5561,173,1,5791,56,2020-07-27,44623
"Hempstead",174,2474,123,2,2648,49,2020-07-27,22018
"Hot Spring",1402,4819,1309,4,6221,89,2020-07-27,33520
"Howard",246,2184,187,2,2430,57,2020-07-27,13389
"Independence",233,4033,103,0,4266,130,2020-07-27,37264
"Izard",34,1247,27,1,1281,6,2020-07-27,13559
"Jackson",54,1664,44,1,1718,9,2020-07-27,17225
"Jefferson",1204,11447,928,36,12651,240,2020-07-27,70424
"Johnson",585,2688,502,0,3273,83,2020-07-27,26291
"Lafayette",47,498,32,2,545,13,2020-07-27,6915
"Lawrence",158,2041,126,9,2199,23,2020-07-27,16669
"Lee",876,2648,850,6,3524,20,2020-07-27,9398
"Lincoln",1152,2395,1045,11,3547,96,2020-07-27,13695
"Little River",82,1074,61,1,1156,20,2020-07-27,12417
"Logan",127,2981,99,0,3108,28,2020-07-27,21757
"Lonoke",356,6928,254,2,7284,100,2020-07-27,72206
"Madison",246,2318,232,1,2564,13,2020-07-27,16078
"Marion",18,1163,17,0,1181,1,2020-07-27,16438
"Miller",423,3550,342,3,3973,78,2020-07-27,43759
"Mississippi",553,5446,415,8,5999,130,2020-07-27,42831
"Monroe",46,1118,29,0,1164,17,2020-07-27,7249
"Montgomery",22,803,17,0,825,5,2020-07-27,8993
"Nevada",126,1463,108,8,1589,10,2020-07-27,8440
"Newton",85,731,16,0,816,69,2020-07-27,7848
"Ouachita",68,2552,45,1,2620,22,2020-07-27,24106
"Perry",44,1286,41,0,1330,3,2020-07-27,10322
"Phillips",250,3298,201,6,3548,43,2020-07-27,19034
"Pike",58,2465,40,1,2523,17,2020-07-27,10808
"Poinsett",125,2298,88,3,2423,34,2020-07-27,24054
"Polk",121,1981,105,0,2102,16,2020-07-27,20163
"Pope",1074,8833,839,6,9907,229,2020-07-27,63644
"Prairie",56,883,48,0,939,8,2020-07-27,8244
"Pulaski",4437,55737,3497,71,60174,869,2020-07-27,393463
"Randolph",142,2494,99,2,2636,41,2020-07-27,17603
"Saline",777,13493,596,3,14270,178,2020-07-27,118009
"Scott",31,840,20,0,871,11,2020-07-27,10442
"Searcy",23,1007,20,0,1030,3,2020-07-27,7923
"Sebastian",1454,17463,1046,13,18917,395,2020-07-27,127461
"Sevier",906,4249,846,9,5155,51,2020-07-27,17193
"Sharp",92,1444,72,5,1536,15,2020-07-27,17043
"St. Francis",1079,5772,951,3,6851,125,2020-07-27,26294
"Stone",43,1511,32,1,1554,10,2020-07-27,12446
"Union",373,3837,305,15,4210,53,2020-07-27,39732
"Van Buren",44,1425,36,2,1469,6,2020-07-27,16684
"Washington",5729,21166,5147,40,26895,542,2020-07-27,228529
"White",222,5483,178,2,5705,42,2020-07-27,78804
"Woodruff",17,954,15,0,971,2,2020-07-27,6660
"Yell",967,3535,893,14,4502,60,2020-07-27,21757
"Arkansas",168,2255,99,1,2423,68,2020-07-26,18124
"Ashley",180,2224,115,4,2404,61,2020-07-26,20537
"Baxter",55,3023,40,0,3078,15,2020-07-26,41219
"Benton",4209,48150,3780,32,52359,397,2020-07-26,258980
"Boone",108,3374,62,1,3482,45,2020-07-26,37288
"Bradley",114,1599,81,2,1713,31,2020-07-26,10948
"Calhoun",10,463,5,0,473,5,2020-07-26,5202
"Carroll",322,3642,252,6,3964,64,2020-07-26,27887
"Chicot",306,1904,235,4,2210,67,2020-07-26,10826
"Clark",132,2422,97,0,2554,35,2020-07-26,22385
"Clay",104,2069,84,4,2173,16,2020-07-26,15061
"Cleburne",174,2912,144,5,3086,25,2020-07-26,25230
"Cleveland",57,1008,39,1,1065,17,2020-07-26,8226
"Columbia",166,2180,126,5,2346,35,2020-07-26,23892
"Conway",122,2562,104,3,2684,15,2020-07-26,20906
"Craighead",945,14782,731,8,15727,206,2020-07-26,105701
"Crawford",447,6848,316,3,7295,128,2020-07-26,62472
"Crittenden",1090,7351,947,16,8441,127,2020-07-26,49013
"Cross",150,1887,109,1,2037,40,2020-07-26,16998
"Dallas",32,710,16,0,742,16,2020-07-26,7432
"Desha",128,1497,89,1,1625,38,2020-07-26,11887
"Drew",139,2521,103,2,2660,34,2020-07-26,18502
"Faulkner",1063,14976,871,4,16039,188,2020-07-26,122416
"Franklin",78,2238,37,1,2316,40,2020-07-26,17780
"Fulton",23,1153,19,0,1176,4,2020-07-26,12139
"Garland",652,11372,432,5,12024,215,2020-07-26,98298
"Grant",113,1894,79,0,2007,34,2020-07-26,18086
"Greene",228,5536,168,1,5764,59,2020-07-26,44623
"Hempstead",167,2434,114,2,2601,51,2020-07-26,22018
"Hot Spring",1397,4758,1301,4,6155,92,2020-07-26,33520
"Howard",236,2147,162,2,2383,72,2020-07-26,13389
"Independence",210,3969,98,0,4179,112,2020-07-26,37264
"Izard",34,1235,26,1,1269,7,2020-07-26,13559
"Jackson",52,1607,44,1,1659,7,2020-07-26,17225
"Jefferson",1171,11269,907,34,12440,230,2020-07-26,70424
"Johnson",574,2617,486,0,3191,88,2020-07-26,26291
"Lafayette",46,494,32,2,540,12,2020-07-26,6915
"Lawrence",157,2023,122,9,2180,26,2020-07-26,16669
"Lee",876,2637,848,6,3513,22,2020-07-26,9398
"Lincoln",1148,2380,1042,11,3528,95,2020-07-26,13695
"Little River",80,1064,56,1,1144,23,2020-07-26,12417
"Logan",122,2933,95,0,3055,27,2020-07-26,21757
"Lonoke",345,6756,243,2,7101,100,2020-07-26,72206
"Madison",245,2302,229,1,2547,15,2020-07-26,16078
"Marion",18,1155,15,0,1173,3,2020-07-26,16438
"Miller",416,3481,333,3,3897,80,2020-07-26,43759
"Mississippi",539,5371,399,8,5910,132,2020-07-26,42831
"Monroe",43,1077,29,0,1120,14,2020-07-26,7249
"Montgomery",19,792,15,0,811,4,2020-07-26,8993
"Nevada",124,1441,106,8,1565,10,2020-07-26,8440
"Newton",84,715,15,0,799,69,2020-07-26,7848
"Ouachita",64,2480,44,1,2544,19,2020-07-26,24106
"Perry",42,1267,39,0,1309,3,2020-07-26,10322
"Phillips",250,3266,192,6,3516,52,2020-07-26,19034
"Pike",57,2426,39,0,2483,18,2020-07-26,10808
"Poinsett",119,2283,84,3,2402,32,2020-07-26,24054
"Polk",120,1952,103,0,2072,17,2020-07-26,20163
"Pope",1045,8658,818,6,9703,221,2020-07-26,63644
"Prairie",56,870,39,0,926,17,2020-07-26,8244
"Pulaski",4346,54664,3360,71,59010,915,2020-07-26,393463
"Randolph",137,2484,94,2,2621,41,2020-07-26,17603
"Saline",741,13200,579,3,13941,159,2020-07-26,118009
"Scott",31,826,19,0,857,12,2020-07-26,10442
"Searcy",22,1002,19,0,1024,3,2020-07-26,7923
"Sebastian",1402,16991,1013,13,18393,376,2020-07-26,127461
"Sevier",900,4202,836,9,5102,55,2020-07-26,17193
"Sharp",92,1426,71,5,1518,16,2020-07-26,17043
"St. Francis",1067,5628,942,3,6695,122,2020-07-26,26294
"Stone",43,1505,29,1,1548,13,2020-07-26,12446
"Union",369,3805,300,15,4174,54,2020-07-26,39732
"Van Buren",43,1421,36,2,1464,5,2020-07-26,16684
"Washington",5662,20759,5085,40,26421,537,2020-07-26,228529
"White",220,5435,169,2,5655,49,2020-07-26,78804
"Woodruff",17,937,15,0,954,2,2020-07-26,6660
"Yell",960,3469,873,14,4429,73,2020-07-26,21757
"Arkansas",168,2222,94,1,2390,73,2020-07-25,18124
"Ashley",172,2177,113,4,2349,55,2020-07-25,20537
"Baxter",55,2986,39,0,3041,16,2020-07-25,41219
"Benton",4156,47551,3736,31,51707,389,2020-07-25,258980
"Boone",106,3307,62,1,3413,43,2020-07-25,37288
"Bradley",114,1548,80,2,1662,32,2020-07-25,10948
"Calhoun",10,453,5,0,463,5,2020-07-25,5202
"Carroll",314,3617,248,6,3931,60,2020-07-25,27887
"Chicot",292,1859,232,3,2151,57,2020-07-25,10826
"Clark",129,2400,94,0,2529,35,2020-07-25,22385
"Clay",102,2020,82,4,2122,16,2020-07-25,15061
"Cleburne",173,2870,142,5,3043,26,2020-07-25,25230
"Cleveland",55,990,38,1,1045,16,2020-07-25,8226
"Columbia",162,2155,122,5,2317,35,2020-07-25,23892
"Conway",121,2529,103,3,2650,15,2020-07-25,20906
"Craighead",931,14279,708,8,15210,215,2020-07-25,105701
"Crawford",438,6725,307,3,7163,128,2020-07-25,62472
"Crittenden",1072,7296,920,16,8368,136,2020-07-25,49013
"Cross",147,1841,107,1,1988,39,2020-07-25,16998
"Dallas",29,703,16,0,732,13,2020-07-25,7432
"Desha",125,1463,87,1,1588,37,2020-07-25,11887
"Drew",129,2436,100,2,2565,27,2020-07-25,18502
"Faulkner",1046,14826,848,4,15872,194,2020-07-25,122416
"Franklin",66,2147,35,1,2213,30,2020-07-25,17780
"Fulton",23,1145,19,0,1168,4,2020-07-25,12139
"Garland",642,11178,421,5,11820,216,2020-07-25,98298
"Grant",111,1856,78,0,1967,33,2020-07-25,18086
"Greene",216,5330,167,1,5546,48,2020-07-25,44623
"Hempstead",163,2373,109,2,2536,52,2020-07-25,22018
"Hot Spring",1392,4752,1297,4,6144,91,2020-07-25,33520
"Howard",228,2079,159,2,2307,67,2020-07-25,13389
"Independence",187,3884,94,0,4071,93,2020-07-25,37264
"Izard",34,1223,26,1,1257,7,2020-07-25,13559
"Jackson",52,1598,43,1,1650,8,2020-07-25,17225
"Jefferson",1146,11141,892,34,12287,220,2020-07-25,70424
"Johnson",560,2554,470,0,3114,90,2020-07-25,26291
"Lafayette",45,489,31,2,534,12,2020-07-25,6915
"Lawrence",155,2009,118,9,2164,28,2020-07-25,16669
"Lee",871,2598,847,6,3469,18,2020-07-25,9398
"Lincoln",1143,2383,1042,11,3526,90,2020-07-25,13695
"Little River",78,1041,54,1,1119,23,2020-07-25,12417
"Logan",120,2870,92,0,2990,28,2020-07-25,21757
"Lonoke",333,6634,239,2,6967,92,2020-07-25,72206
"Madison",245,2260,229,1,2505,15,2020-07-25,16078
"Marion",18,1151,14,0,1169,4,2020-07-25,16438
"Miller",403,3438,320,3,3841,80,2020-07-25,43759
"Mississippi",535,5262,391,8,5797,136,2020-07-25,42831
"Monroe",41,1062,27,0,1103,14,2020-07-25,7249
"Montgomery",19,785,15,0,804,4,2020-07-25,8993
"Nevada",123,1429,103,8,1552,12,2020-07-25,8440
"Newton",83,703,12,0,786,71,2020-07-25,7848
"Ouachita",61,2455,44,1,2516,16,2020-07-25,24106
"Perry",41,1260,39,0,1301,2,2020-07-25,10322
"Phillips",242,3232,189,6,3474,47,2020-07-25,19034
"Pike",55,2400,36,0,2455,19,2020-07-25,10808
"Poinsett",117,2202,85,3,2319,29,2020-07-25,24054
"Polk",120,1924,99,0,2044,21,2020-07-25,20163
"Pope",1021,8518,801,6,9539,214,2020-07-25,63644
"Prairie",56,852,39,0,908,17,2020-07-25,8244
"Pulaski",4297,54004,3284,71,58301,942,2020-07-25,393463
"Randolph",136,2441,91,2,2577,43,2020-07-25,17603
"Saline",733,13002,567,3,13735,163,2020-07-25,118009
"Scott",30,809,19,0,839,11,2020-07-25,10442
"Searcy",22,991,19,0,1013,3,2020-07-25,7923
"Sebastian",1354,16672,979,13,18026,362,2020-07-25,127461
"Sevier",896,4103,834,9,4999,53,2020-07-25,17193
"Sharp",89,1413,68,5,1502,16,2020-07-25,17043
"St. Francis",1050,5458,935,3,6508,112,2020-07-25,26294
"Stone",42,1489,29,1,1531,12,2020-07-25,12446
"Union",361,3787,296,15,4148,50,2020-07-25,39732
"Van Buren",43,1393,36,2,1436,5,2020-07-25,16684
"Washington",5576,20410,5027,40,25986,509,2020-07-25,228529
"White",212,5325,159,2,5537,51,2020-07-25,78804
"Woodruff",17,933,15,0,950,2,2020-07-25,6660
"Yell",951,3411,860,14,4362,77,2020-07-25,21757
"Arkansas",164,2189,83,1,2353,80,2020-07-24,18124
"Ashley",164,2121,104,4,2285,56,2020-07-24,20537
"Baxter",52,2928,38,0,2980,14,2020-07-24,41219
"Benton",4126,46843,3641,31,50969,454,2020-07-24,258980
"Boone",104,3265,58,1,3369,45,2020-07-24,37288
"Bradley",112,1521,77,2,1633,33,2020-07-24,10948
"Calhoun",8,450,5,0,458,3,2020-07-24,5202
"Carroll",309,3581,238,6,3890,65,2020-07-24,27887
"Chicot",284,1820,209,3,2104,72,2020-07-24,10826
"Clark",125,2342,90,0,2467,35,2020-07-24,22385
"Clay",101,1984,79,4,2085,18,2020-07-24,15061
"Cleburne",167,2810,138,5,2977,24,2020-07-24,25230
"Cleveland",55,964,38,1,1019,16,2020-07-24,8226
"Columbia",158,2072,117,5,2230,36,2020-07-24,23892
"Conway",119,2476,96,3,2595,20,2020-07-24,20906
"Craighead",895,14042,690,8,14937,197,2020-07-24,105701
"Crawford",429,6598,299,3,7027,127,2020-07-24,62472
"Crittenden",1058,7207,896,16,8265,146,2020-07-24,49013
"Cross",137,1797,104,1,1934,32,2020-07-24,16998
"Dallas",26,683,13,0,709,13,2020-07-24,7432
"Desha",125,1430,83,1,1555,41,2020-07-24,11887
"Drew",126,2384,90,2,2510,34,2020-07-24,18502
"Faulkner",1013,14437,823,4,15450,186,2020-07-24,122416
"Franklin",63,2087,34,1,2150,28,2020-07-24,17780
"Fulton",22,1135,19,0,1157,3,2020-07-24,12139
"Garland",604,10780,395,5,11384,204,2020-07-24,98298
"Grant",100,1767,76,0,1867,24,2020-07-24,18086
"Greene",211,5254,160,1,5465,50,2020-07-24,44623
"Hempstead",159,2293,102,2,2452,55,2020-07-24,22018
"Hot Spring",1382,4651,1117,4,6033,261,2020-07-24,33520
"Howard",222,2053,152,1,2275,69,2020-07-24,13389
"Independence",181,3794,88,0,3975,93,2020-07-24,37264
"Izard",31,1191,25,1,1222,5,2020-07-24,13559
"Jackson",48,1577,40,1,1625,7,2020-07-24,17225
"Jefferson",1133,10843,851,33,11976,249,2020-07-24,70424
"Johnson",554,2534,456,0,3088,98,2020-07-24,26291
"Lafayette",43,484,29,2,527,12,2020-07-24,6915
"Lawrence",152,1961,111,9,2113,32,2020-07-24,16669
"Lee",869,2586,820,6,3455,43,2020-07-24,9398
"Lincoln",1141,2361,1028,11,3502,102,2020-07-24,13695
"Little River",77,1028,50,1,1105,26,2020-07-24,12417
"Logan",118,2801,88,0,2919,30,2020-07-24,21757
"Lonoke",324,6461,229,2,6785,93,2020-07-24,72206
"Madison",242,2246,223,1,2488,18,2020-07-24,16078
"Marion",18,1142,13,0,1160,5,2020-07-24,16438
"Miller",385,3362,312,2,3747,71,2020-07-24,43759
"Mississippi",523,5182,375,7,5705,141,2020-07-24,42831
"Monroe",38,1025,27,0,1063,11,2020-07-24,7249
"Montgomery",19,770,13,0,789,6,2020-07-24,8993
"Nevada",119,1417,87,8,1536,24,2020-07-24,8440
"Newton",73,676,12,0,749,61,2020-07-24,7848
"Ouachita",59,2412,43,1,2471,15,2020-07-24,24106
"Perry",41,1236,36,0,1277,5,2020-07-24,10322
"Phillips",230,3200,174,6,3430,50,2020-07-24,19034
"Pike",49,2346,31,0,2395,18,2020-07-24,10808
"Poinsett",112,2169,82,3,2281,27,2020-07-24,24054
"Polk",111,1877,96,0,1988,15,2020-07-24,20163
"Pope",1004,8395,770,5,9399,229,2020-07-24,63644
"Prairie",56,817,38,0,873,18,2020-07-24,8244
"Pulaski",4183,52494,3134,71,56677,978,2020-07-24,393463
"Randolph",133,2378,78,2,2511,53,2020-07-24,17603
"Saline",701,12625,542,3,13326,156,2020-07-24,118009
"Scott",26,795,19,0,821,7,2020-07-24,10442
"Searcy",22,980,18,0,1002,4,2020-07-24,7923
"Sebastian",1318,16357,916,13,17675,389,2020-07-24,127461
"Sevier",893,4050,823,9,4943,61,2020-07-24,17193
"Sharp",89,1393,64,5,1482,20,2020-07-24,17043
"St. Francis",998,5312,922,3,6310,73,2020-07-24,26294
"Stone",40,1475,27,1,1515,12,2020-07-24,12446
"Union",350,3696,276,15,4046,59,2020-07-24,39732
"Van Buren",42,1374,36,2,1416,4,2020-07-24,16684
"Washington",5536,20064,4884,40,25600,612,2020-07-24,228529
"White",189,5185,152,2,5374,35,2020-07-24,78804
"Woodruff",17,898,15,0,915,2,2020-07-24,6660
"Yell",944,3360,831,14,4304,99,2020-07-24,21757
"Arkansas",157,2081,73,1,2238,83,2020-07-23,18124
"Ashley",153,2106,102,4,2259,47,2020-07-23,20537
"Baxter",49,2911,37,0,2960,12,2020-07-23,41219
"Benton",4068,45326,3595,30,49394,443,2020-07-23,258980
"Boone",92,3252,56,1,3344,35,2020-07-23,37288
"Bradley",106,1503,75,2,1609,29,2020-07-23,10948
"Calhoun",8,449,5,0,457,3,2020-07-23,5202
"Carroll",304,3545,232,6,3849,66,2020-07-23,27887
"Chicot",282,1807,206,3,2089,73,2020-07-23,10826
"Clark",120,2320,88,0,2440,32,2020-07-23,22385
"Clay",101,1975,78,4,2076,19,2020-07-23,15061
"Cleburne",165,2774,137,5,2939,23,2020-07-23,25230
"Cleveland",50,957,38,0,1007,12,2020-07-23,8226
"Columbia",152,2060,113,5,2212,34,2020-07-23,23892
"Conway",118,2434,93,3,2552,22,2020-07-23,20906
"Craighead",873,13876,672,8,14749,193,2020-07-23,105701
"Crawford",393,6403,289,3,6796,101,2020-07-23,62472
"Crittenden",1044,7124,881,15,8168,148,2020-07-23,49013
"Cross",131,1787,101,1,1918,29,2020-07-23,16998
"Dallas",24,682,12,0,706,12,2020-07-23,7432
"Desha",123,1426,77,1,1549,45,2020-07-23,11887
"Drew",124,2347,87,2,2471,35,2020-07-23,18502
"Faulkner",996,14229,808,4,15225,184,2020-07-23,122416
"Franklin",61,2057,34,1,2118,26,2020-07-23,17780
"Fulton",22,1131,19,0,1153,3,2020-07-23,12139
"Garland",581,10671,376,5,11252,200,2020-07-23,98298
"Grant",95,1736,71,0,1831,24,2020-07-23,18086
"Greene",208,5192,156,0,5400,52,2020-07-23,44623
"Hempstead",150,2276,94,2,2426,54,2020-07-23,22018
"Hot Spring",1372,4616,800,2,5988,570,2020-07-23,33520
"Howard",217,2033,146,1,2250,70,2020-07-23,13389
"Independence",152,3779,85,0,3931,67,2020-07-23,37264
"Izard",30,1186,25,1,1216,4,2020-07-23,13559
"Jackson",47,1568,38,1,1615,8,2020-07-23,17225
"Jefferson",1094,10753,840,32,11847,222,2020-07-23,70424
"Johnson",540,2392,446,0,2932,94,2020-07-23,26291
"Lafayette",42,483,29,2,525,11,2020-07-23,6915
"Lawrence",150,1946,106,9,2096,35,2020-07-23,16669
"Lee",868,2574,820,6,3442,42,2020-07-23,9398
"Lincoln",1138,2348,1027,11,3486,100,2020-07-23,13695
"Little River",75,1019,48,1,1094,26,2020-07-23,12417
"Logan",117,2772,86,0,2889,31,2020-07-23,21757
"Lonoke",291,6224,213,2,6515,76,2020-07-23,72206
"Madison",238,2203,220,1,2441,17,2020-07-23,16078
"Marion",18,1137,13,0,1155,5,2020-07-23,16438
"Miller",379,3344,297,2,3723,80,2020-07-23,43759
"Mississippi",511,5142,360,7,5653,144,2020-07-23,42831
"Monroe",37,1010,25,0,1047,12,2020-07-23,7249
"Montgomery",18,765,12,0,783,6,2020-07-23,8993
"Nevada",117,1412,86,8,1529,23,2020-07-23,8440
"Newton",18,654,11,0,672,7,2020-07-23,7848
"Ouachita",61,2396,39,1,2457,21,2020-07-23,24106
"Perry",41,1218,34,0,1259,7,2020-07-23,10322
"Phillips",226,3188,170,6,3414,50,2020-07-23,19034
"Pike",49,2333,29,0,2382,20,2020-07-23,10808
"Poinsett",111,2127,81,3,2238,27,2020-07-23,24054
"Polk",109,1861,95,0,1970,14,2020-07-23,20163
"Pope",966,8184,746,5,9150,215,2020-07-23,63644
"Prairie",53,802,35,0,855,18,2020-07-23,8244
"Pulaski",4044,50965,3039,70,55009,935,2020-07-23,393463
"Randolph",121,2367,75,2,2488,44,2020-07-23,17603
"Saline",667,12304,511,3,12971,153,2020-07-23,118009
"Scott",26,783,19,0,809,7,2020-07-23,10442
"Searcy",21,977,18,0,998,3,2020-07-23,7923
"Sebastian",1278,16230,887,13,17508,378,2020-07-23,127461
"Sevier",893,4030,816,9,4923,68,2020-07-23,17193
"Sharp",86,1381,64,5,1467,17,2020-07-23,17043
"St. Francis",981,5206,915,3,6187,63,2020-07-23,26294
"Stone",39,1463,25,1,1502,13,2020-07-23,12446
"Union",345,3667,270,15,4012,60,2020-07-23,39732
"Van Buren",41,1365,36,2,1406,3,2020-07-23,16684
"Washington",5451,19680,4794,40,25131,617,2020-07-23,228529
"White",185,5092,146,2,5277,37,2020-07-23,78804
"Woodruff",17,892,14,0,909,3,2020-07-23,6660
"Yell",942,3321,818,14,4263,110,2020-07-23,21757
"Arkansas",146,2060,67,1,2206,78,2020-07-22,18124
"Ashley",142,2042,97,4,2184,41,2020-07-22,20537
"Baxter",48,2860,34,0,2908,14,2020-07-22,41219
"Benton",3985,44465,3513,29,48450,443,2020-07-22,258980
"Boone",83,3170,50,1,3253,32,2020-07-22,37288
"Bradley",104,1487,69,2,1591,33,2020-07-22,10948
"Calhoun",8,448,5,0,456,3,2020-07-22,5202
"Carroll",294,3469,224,6,3763,64,2020-07-22,27887
"Chicot",266,1753,201,3,2019,62,2020-07-22,10826
"Clark",107,2294,85,0,2401,22,2020-07-22,22385
"Clay",94,1929,74,4,2023,16,2020-07-22,15061
"Cleburne",160,2746,133,5,2906,22,2020-07-22,25230
"Cleveland",49,947,37,0,996,12,2020-07-22,8226
"Columbia",147,2026,105,5,2173,37,2020-07-22,23892
"Conway",117,2359,90,3,2476,24,2020-07-22,20906
"Craighead",828,13558,637,8,14386,183,2020-07-22,105701
"Crawford",379,6250,276,3,6629,100,2020-07-22,62472
"Crittenden",994,6940,858,15,7934,121,2020-07-22,49013
"Cross",124,1765,98,1,1889,25,2020-07-22,16998
"Dallas",22,674,12,0,696,10,2020-07-22,7432
"Desha",117,1393,74,1,1510,42,2020-07-22,11887
"Drew",117,2260,82,2,2377,33,2020-07-22,18502
"Faulkner",970,13930,788,4,14900,178,2020-07-22,122416
"Franklin",60,2005,30,1,2065,29,2020-07-22,17780
"Fulton",21,1114,18,0,1135,3,2020-07-22,12139
"Garland",549,10434,355,5,10983,189,2020-07-22,98298
"Grant",94,1713,66,0,1807,28,2020-07-22,18086
"Greene",191,4980,152,0,5171,39,2020-07-22,44623
"Hempstead",145,2235,88,2,2380,55,2020-07-22,22018
"Hot Spring",1367,4555,749,2,5922,616,2020-07-22,33520
"Howard",209,2009,139,1,2218,69,2020-07-22,13389
"Independence",126,3682,77,0,3808,49,2020-07-22,37264
"Izard",29,1169,24,1,1198,4,2020-07-22,13559
"Jackson",47,1546,38,1,1593,8,2020-07-22,17225
"Jefferson",1069,10612,820,32,11681,217,2020-07-22,70424
"Johnson",515,2314,427,0,2829,88,2020-07-22,26291
"Lafayette",41,474,28,2,515,11,2020-07-22,6915
"Lawrence",148,1923,104,9,2071,35,2020-07-22,16669
"Lee",867,2557,814,6,3424,47,2020-07-22,9398
"Lincoln",1132,2316,1026,11,3448,95,2020-07-22,13695
"Little River",72,1013,48,1,1085,23,2020-07-22,12417
"Logan",112,2708,80,0,2820,32,2020-07-22,21757
"Lonoke",276,6150,206,2,6426,68,2020-07-22,72206
"Madison",238,2176,219,1,2414,18,2020-07-22,16078
"Marion",17,1121,12,0,1138,5,2020-07-22,16438
"Miller",368,3315,285,2,3683,81,2020-07-22,43759
"Mississippi",489,5016,339,7,5505,143,2020-07-22,42831
"Monroe",36,1004,25,0,1040,11,2020-07-22,7249
"Montgomery",16,759,12,0,775,4,2020-07-22,8993
"Nevada",117,1399,85,8,1516,24,2020-07-22,8440
"Newton",18,642,10,0,660,8,2020-07-22,7848
"Ouachita",55,2341,35,1,2396,19,2020-07-22,24106
"Perry",39,1183,34,0,1222,5,2020-07-22,10322
"Phillips",219,3120,166,6,3339,47,2020-07-22,19034
"Pike",43,2267,28,0,2310,15,2020-07-22,10808
"Poinsett",109,2079,77,3,2188,29,2020-07-22,24054
"Polk",106,1851,93,0,1957,13,2020-07-22,20163
"Pope",937,7948,721,5,8885,211,2020-07-22,63644
"Prairie",52,786,33,0,838,19,2020-07-22,8244
"Pulaski",3923,50183,2923,69,54106,931,2020-07-22,393463
"Randolph",115,2347,72,2,2462,41,2020-07-22,17603
"Saline",637,12090,486,3,12727,148,2020-07-22,118009
"Scott",21,760,17,0,781,4,2020-07-22,10442
"Searcy",20,951,18,0,971,2,2020-07-22,7923
"Sebastian",1214,15786,839,11,17000,364,2020-07-22,127461
"Sevier",880,4015,805,9,4895,66,2020-07-22,17193
"Sharp",83,1347,62,5,1430,16,2020-07-22,17043
"St. Francis",968,5065,910,3,6033,55,2020-07-22,26294
"Stone",37,1449,21,1,1486,15,2020-07-22,12446
"Union",335,3639,260,14,3974,61,2020-07-22,39732
"Van Buren",40,1347,36,2,1387,2,2020-07-22,16684
"Washington",5350,19302,4671,39,24652,640,2020-07-22,228529
"White",182,5018,141,2,5200,39,2020-07-22,78804
"Woodruff",17,886,15,0,903,2,2020-07-22,6660
"Yell",928,3279,801,14,4207,113,2020-07-22,21757
"Arkansas",144,2038,58,1,2182,85,2020-07-21,18124
"Ashley",138,1993,93,4,2131,41,2020-07-21,20537
"Baxter",46,2855,34,0,2901,12,2020-07-21,41219
"Benton",3939,44198,3440,28,48137,471,2020-07-21,258980
"Boone",81,3161,45,1,3242,35,2020-07-21,37288
"Bradley",103,1479,67,2,1582,34,2020-07-21,10948
"Calhoun",7,446,5,0,453,2,2020-07-21,5202
"Carroll",291,3458,219,6,3749,66,2020-07-21,27887
"Chicot",264,1749,190,3,2013,71,2020-07-21,10826
"Clark",105,2283,80,0,2388,25,2020-07-21,22385
"Clay",92,1905,74,3,1997,15,2020-07-21,15061
"Cleburne",159,2710,129,5,2869,25,2020-07-21,25230
"Cleveland",46,940,35,0,986,11,2020-07-21,8226
"Columbia",141,2013,102,5,2154,34,2020-07-21,23892
"Conway",115,2302,88,3,2417,24,2020-07-21,20906
"Craighead",795,13230,616,8,14025,171,2020-07-21,105701
"Crawford",370,6173,263,3,6543,104,2020-07-21,62472
"Crittenden",972,6841,844,15,7813,113,2020-07-21,49013
"Cross",121,1742,99,1,1863,21,2020-07-21,16998
"Dallas",21,670,12,0,691,9,2020-07-21,7432
"Desha",116,1386,73,1,1502,42,2020-07-21,11887
"Drew",116,2251,82,2,2367,32,2020-07-21,18502
"Faulkner",940,13455,740,4,14395,196,2020-07-21,122416
"Franklin",59,1965,30,1,2024,28,2020-07-21,17780
"Fulton",21,1112,18,0,1133,3,2020-07-21,12139
"Garland",519,10238,341,5,10757,173,2020-07-21,98298
"Grant",90,1698,63,0,1788,27,2020-07-21,18086
"Greene",185,4893,152,0,5078,33,2020-07-21,44623
"Hempstead",134,2209,82,2,2343,50,2020-07-21,22018
"Hot Spring",1362,4521,745,2,5883,615,2020-07-21,33520
"Howard",196,1975,136,1,2171,59,2020-07-21,13389
"Independence",125,3666,74,0,3791,51,2020-07-21,37264
"Izard",29,1166,24,1,1195,4,2020-07-21,13559
"Jackson",47,1536,38,0,1583,9,2020-07-21,17225
"Jefferson",1063,10552,797,32,11615,234,2020-07-21,70424
"Johnson",506,2134,409,0,2640,97,2020-07-21,26291
"Lafayette",38,469,26,2,507,10,2020-07-21,6915
"Lawrence",144,1905,100,9,2049,35,2020-07-21,16669
"Lee",866,2554,812,6,3420,48,2020-07-21,9398
"Lincoln",1132,2310,1024,11,3442,97,2020-07-21,13695
"Little River",67,1001,48,1,1068,18,2020-07-21,12417
"Logan",112,2657,80,0,2769,32,2020-07-21,21757
"Lonoke",266,6079,204,2,6345,60,2020-07-21,72206
"Madison",236,2158,215,1,2394,20,2020-07-21,16078
"Marion",16,1109,12,0,1125,4,2020-07-21,16438
"Miller",363,3269,276,2,3632,85,2020-07-21,43759
"Mississippi",475,4891,320,7,5366,148,2020-07-21,42831
"Monroe",35,994,24,0,1029,11,2020-07-21,7249
"Montgomery",15,754,10,0,769,5,2020-07-21,8993
"Nevada",117,1391,86,7,1508,24,2020-07-21,8440
"Newton",17,629,10,0,646,7,2020-07-21,7848
"Ouachita",55,2323,33,1,2378,21,2020-07-21,24106
"Perry",39,1163,34,0,1202,5,2020-07-21,10322
"Phillips",217,3104,159,6,3321,52,2020-07-21,19034
"Pike",39,2242,26,0,2281,13,2020-07-21,10808
"Poinsett",102,2018,70,3,2120,29,2020-07-21,24054
"Polk",106,1837,91,0,1943,15,2020-07-21,20163
"Pope",913,7579,693,5,8492,215,2020-07-21,63644
"Prairie",52,782,32,0,834,20,2020-07-21,8244
"Pulaski",3843,49164,2849,69,53007,925,2020-07-21,393463
"Randolph",106,2321,70,2,2427,34,2020-07-21,17603
"Saline",625,11948,469,3,12573,153,2020-07-21,118009
"Scott",21,755,15,0,776,6,2020-07-21,10442
"Searcy",20,945,17,0,965,3,2020-07-21,7923
"Sebastian",1197,15630,799,10,16827,388,2020-07-21,127461
"Sevier",869,3962,800,9,4831,60,2020-07-21,17193
"Sharp",81,1341,60,5,1422,16,2020-07-21,17043
"St. Francis",964,5027,904,3,5991,57,2020-07-21,26294
"Stone",37,1444,21,1,1481,15,2020-07-21,12446
"Union",333,3619,256,14,3952,63,2020-07-21,39732
"Van Buren",39,1327,36,2,1366,1,2020-07-21,16684
"Washington",5312,19143,4571,39,24455,702,2020-07-21,228529
"White",177,4992,138,2,5169,37,2020-07-21,78804
"Woodruff",17,880,15,0,897,2,2020-07-21,6660
"Yell",927,3088,784,13,4015,130,2020-07-21,21757
"Arkansas",134,1984,52,1,2118,81,2020-07-20,18124
"Ashley",137,1973,91,3,2110,43,2020-07-20,20537
"Baxter",44,2799,33,0,2843,11,2020-07-20,41219
"Benton",3887,43529,3363,27,47416,497,2020-07-20,258980
"Boone",79,3108,42,1,3187,36,2020-07-20,37288
"Bradley",101,1447,63,2,1548,36,2020-07-20,10948
"Calhoun",6,439,3,0,445,3,2020-07-20,5202
"Carroll",286,3412,217,6,3698,63,2020-07-20,27887
"Chicot",260,1746,184,3,2006,73,2020-07-20,10826
"Clark",103,2259,77,0,2362,26,2020-07-20,22385
"Clay",90,1900,72,3,1990,15,2020-07-20,15061
"Cleburne",156,2689,124,5,2845,27,2020-07-20,25230
"Cleveland",43,922,34,0,965,9,2020-07-20,8226
"Columbia",139,1986,95,5,2125,39,2020-07-20,23892
"Conway",114,2255,85,3,2369,26,2020-07-20,20906
"Craighead",739,13099,577,8,13838,154,2020-07-20,105701
"Crawford",360,6045,254,3,6405,103,2020-07-20,62472
"Crittenden",957,6758,825,15,7715,117,2020-07-20,49013
"Cross",117,1719,92,1,1836,24,2020-07-20,16998
"Dallas",21,662,12,0,683,9,2020-07-20,7432
"Desha",110,1372,72,1,1482,37,2020-07-20,11887
"Drew",116,2221,80,2,2337,34,2020-07-20,18502
"Faulkner",926,13194,716,4,14120,206,2020-07-20,122416
"Franklin",44,1854,30,1,1898,13,2020-07-20,17780
"Fulton",20,1107,17,0,1127,3,2020-07-20,12139
"Garland",499,10092,330,5,10591,164,2020-07-20,98298
"Grant",83,1670,61,0,1753,22,2020-07-20,18086
"Greene",175,4877,144,0,5052,31,2020-07-20,44623
"Hempstead",131,2183,80,1,2314,50,2020-07-20,22018
"Hot Spring",1354,4491,605,2,5845,747,2020-07-20,33520
"Howard",178,1921,132,1,2099,45,2020-07-20,13389
"Independence",114,3630,70,0,3744,44,2020-07-20,37264
"Izard",28,1155,22,1,1183,5,2020-07-20,13559
"Jackson",48,1524,36,0,1572,12,2020-07-20,17225
"Jefferson",1029,10384,770,30,11413,229,2020-07-20,70424
"Johnson",500,1999,400,0,2499,100,2020-07-20,26291
"Lafayette",38,453,25,2,491,11,2020-07-20,6915
"Lawrence",142,1890,97,9,2032,36,2020-07-20,16669
"Lee",865,2545,786,5,3410,74,2020-07-20,9398
"Lincoln",1121,2228,1022,11,3349,88,2020-07-20,13695
"Little River",65,993,47,1,1058,17,2020-07-20,12417
"Logan",110,2593,74,0,2703,36,2020-07-20,21757
"Lonoke",261,5996,198,2,6257,61,2020-07-20,72206
"Madison",231,2124,213,1,2355,17,2020-07-20,16078
"Marion",15,1107,12,0,1122,3,2020-07-20,16438
"Miller",360,3229,272,2,3589,86,2020-07-20,43759
"Mississippi",450,4826,297,6,5276,147,2020-07-20,42831
"Monroe",35,979,24,0,1014,11,2020-07-20,7249
"Montgomery",15,747,9,0,762,6,2020-07-20,8993
"Nevada",117,1373,85,6,1490,26,2020-07-20,8440
"Newton",17,615,9,0,632,8,2020-07-20,7848
"Ouachita",52,2288,32,1,2340,19,2020-07-20,24106
"Perry",39,1146,33,0,1185,6,2020-07-20,10322
"Phillips",214,3080,155,6,3294,53,2020-07-20,19034
"Pike",35,2210,20,0,2245,15,2020-07-20,10808
"Poinsett",96,2004,69,3,2100,24,2020-07-20,24054
"Polk",104,1814,88,0,1918,16,2020-07-20,20163
"Pope",875,7371,657,4,8246,214,2020-07-20,63644
"Prairie",49,775,29,0,824,20,2020-07-20,8244
"Pulaski",3717,48033,2751,69,51750,897,2020-07-20,393463
"Randolph",98,2308,67,2,2406,29,2020-07-20,17603
"Saline",594,11790,451,3,12384,140,2020-07-20,118009
"Scott",21,735,15,0,756,6,2020-07-20,10442
"Searcy",20,936,15,0,956,5,2020-07-20,7923
"Sebastian",1166,15406,761,9,16572,396,2020-07-20,127461
"Sevier",861,3939,789,9,4800,63,2020-07-20,17193
"Sharp",81,1333,55,5,1414,21,2020-07-20,17043
"St. Francis",960,4960,901,3,5920,56,2020-07-20,26294
"Stone",32,1437,20,1,1469,11,2020-07-20,12446
"Union",313,3544,252,14,3857,47,2020-07-20,39732
"Van Buren",38,1302,36,2,1340,0,2020-07-20,16684
"Washington",5234,18791,4463,38,24025,733,2020-07-20,228529
"White",169,4942,130,2,5111,37,2020-07-20,78804
"Woodruff",18,867,13,0,885,5,2020-07-20,6660
"Yell",916,2978,768,13,3894,135,2020-07-20,21757
"Arkansas",113,1933,48,1,2046,64,2020-07-19,18124
"Ashley",134,1945,91,3,2079,40,2020-07-19,20537
"Baxter",44,2772,33,0,2816,11,2020-07-19,41219
"Benton",3832,43039,3324,25,46871,483,2020-07-19,258980
"Boone",76,3059,42,1,3135,33,2020-07-19,37288
"Bradley",97,1384,62,2,1481,33,2020-07-19,10948
"Calhoun",5,429,3,0,434,2,2020-07-19,5202
"Carroll",270,3351,213,6,3621,51,2020-07-19,27887
"Chicot",257,1722,183,3,1979,71,2020-07-19,10826
"Clark",97,2232,73,0,2329,24,2020-07-19,22385
"Clay",89,1871,70,3,1960,16,2020-07-19,15061
"Cleburne",154,2653,121,5,2807,28,2020-07-19,25230
"Cleveland",41,913,33,0,954,8,2020-07-19,8226
"Columbia",134,1939,93,5,2073,36,2020-07-19,23892
"Conway",113,2203,84,3,2316,26,2020-07-19,20906
"Craighead",710,12914,552,8,13624,150,2020-07-19,105701
"Crawford",353,5990,241,3,6343,109,2020-07-19,62472
"Crittenden",944,6697,816,14,7641,114,2020-07-19,49013
"Cross",115,1686,88,1,1801,26,2020-07-19,16998
"Dallas",20,652,12,0,672,8,2020-07-19,7432
"Desha",102,1339,72,1,1441,29,2020-07-19,11887
"Drew",113,2176,78,2,2289,33,2020-07-19,18502
"Faulkner",905,12891,691,4,13796,210,2020-07-19,122416
"Franklin",41,1812,30,1,1853,10,2020-07-19,17780
"Fulton",20,1102,16,0,1122,4,2020-07-19,12139
"Garland",473,9898,318,5,10371,150,2020-07-19,98298
"Grant",79,1637,60,0,1716,19,2020-07-19,18086
"Greene",171,4803,142,0,4974,29,2020-07-19,44623
"Hempstead",122,2095,77,1,2217,44,2020-07-19,22018
"Hot Spring",1349,4425,601,2,5774,746,2020-07-19,33520
"Howard",169,1816,131,1,1985,37,2020-07-19,13389
"Independence",110,3573,69,0,3683,41,2020-07-19,37264
"Izard",28,1149,22,1,1177,5,2020-07-19,13559
"Jackson",46,1504,35,0,1550,11,2020-07-19,17225
"Jefferson",1023,10263,757,30,11286,236,2020-07-19,70424
"Johnson",485,1864,380,0,2349,105,2020-07-19,26291
"Lafayette",37,441,23,2,478,12,2020-07-19,6915
"Lawrence",135,1871,95,9,2006,31,2020-07-19,16669
"Lee",861,2466,785,5,3327,71,2020-07-19,9398
"Lincoln",1119,2138,1020,11,3257,88,2020-07-19,13695
"Little River",63,959,47,1,1022,15,2020-07-19,12417
"Logan",103,2535,69,0,2638,34,2020-07-19,21757
"Lonoke",257,5932,190,2,6189,65,2020-07-19,72206
"Madison",229,2100,213,1,2329,15,2020-07-19,16078
"Marion",15,1087,12,0,1102,3,2020-07-19,16438
"Miller",336,2924,251,2,3260,83,2020-07-19,43759
"Mississippi",421,4740,288,5,5161,128,2020-07-19,42831
"Monroe",33,968,22,0,1001,11,2020-07-19,7249
"Montgomery",14,736,9,0,750,5,2020-07-19,8993
"Nevada",117,1359,85,6,1476,26,2020-07-19,8440
"Newton",16,601,9,0,617,7,2020-07-19,7848
"Ouachita",49,2216,30,1,2265,18,2020-07-19,24106
"Perry",40,1128,34,0,1168,6,2020-07-19,10322
"Phillips",208,3019,152,6,3227,50,2020-07-19,19034
"Pike",32,2170,17,0,2202,15,2020-07-19,10808
"Poinsett",92,1973,66,3,2065,23,2020-07-19,24054
"Polk",103,1793,87,0,1896,16,2020-07-19,20163
"Pope",849,7062,633,4,7911,212,2020-07-19,63644
"Prairie",45,758,28,0,803,17,2020-07-19,8244
"Pulaski",3652,47295,2660,69,50947,923,2020-07-19,393463
"Randolph",97,2272,65,2,2369,30,2020-07-19,17603
"Saline",584,11416,438,3,12000,143,2020-07-19,118009
"Scott",20,719,14,0,739,6,2020-07-19,10442
"Searcy",19,918,15,0,937,4,2020-07-19,7923
"Sebastian",1144,15239,734,9,16383,401,2020-07-19,127461
"Sevier",857,3895,780,9,4752,68,2020-07-19,17193
"Sharp",80,1312,53,5,1392,22,2020-07-19,17043
"St. Francis",953,4883,897,3,5836,53,2020-07-19,26294
"Stone",29,1400,20,1,1429,8,2020-07-19,12446
"Union",306,3501,246,14,3807,46,2020-07-19,39732
"Van Buren",38,1275,35,2,1313,1,2020-07-19,16684
"Washington",5139,18333,4406,37,23472,696,2020-07-19,228529
"White",169,4886,126,2,5055,41,2020-07-19,78804
"Woodruff",18,864,11,0,882,7,2020-07-19,6660
"Yell",912,2834,758,12,3746,142,2020-07-19,21757
"Arkansas",108,1887,46,1,1995,61,2020-07-18,18124
"Ashley",125,1909,90,3,2034,32,2020-07-18,20537
"Baxter",40,2739,29,0,2779,11,2020-07-18,41219
"Benton",3789,42481,3268,25,46270,496,2020-07-18,258980
"Boone",74,3031,41,1,3105,32,2020-07-18,37288
"Bradley",91,1374,61,2,1465,28,2020-07-18,10948
"Calhoun",5,427,3,0,432,2,2020-07-18,5202
"Carroll",262,3307,208,6,3569,48,2020-07-18,27887
"Chicot",252,1696,172,3,1948,77,2020-07-18,10826
"Clark",94,2201,72,0,2295,22,2020-07-18,22385
"Clay",88,1844,70,3,1932,15,2020-07-18,15061
"Cleburne",153,2626,120,5,2779,28,2020-07-18,25230
"Cleveland",41,903,33,0,944,8,2020-07-18,8226
"Columbia",132,1923,91,5,2055,36,2020-07-18,23892
"Conway",111,2169,82,3,2280,26,2020-07-18,20906
"Craighead",701,12824,542,7,13525,152,2020-07-18,105701
"Crawford",347,5873,238,3,6220,106,2020-07-18,62472
"Crittenden",929,6641,808,14,7570,107,2020-07-18,49013
"Cross",113,1664,87,1,1777,25,2020-07-18,16998
"Dallas",20,641,11,0,661,9,2020-07-18,7432
"Desha",98,1321,66,1,1419,31,2020-07-18,11887
"Drew",111,2133,77,2,2244,32,2020-07-18,18502
"Faulkner",888,12757,667,4,13645,217,2020-07-18,122416
"Franklin",37,1780,30,1,1817,6,2020-07-18,17780
"Fulton",20,1078,16,0,1098,4,2020-07-18,12139
"Garland",442,9594,312,5,10036,125,2020-07-18,98298
"Grant",77,1612,55,0,1689,22,2020-07-18,18086
"Greene",168,4726,138,0,4894,30,2020-07-18,44623
"Hempstead",112,2046,73,1,2158,38,2020-07-18,22018
"Hot Spring",1344,4294,593,2,5638,749,2020-07-18,33520
"Howard",167,1791,128,1,1958,38,2020-07-18,13389
"Independence",107,3520,69,0,3627,38,2020-07-18,37264
"Izard",28,1136,22,1,1164,5,2020-07-18,13559
"Jackson",44,1494,35,0,1538,9,2020-07-18,17225
"Jefferson",969,9705,748,30,10674,191,2020-07-18,70424
"Johnson",476,1815,373,0,2291,103,2020-07-18,26291
"Lafayette",36,436,22,2,472,12,2020-07-18,6915
"Lawrence",133,1854,95,9,1987,29,2020-07-18,16669
"Lee",859,2457,785,6,3316,68,2020-07-18,9398
"Lincoln",1118,2124,1020,11,3242,87,2020-07-18,13695
"Little River",60,945,46,1,1005,13,2020-07-18,12417
"Logan",103,2500,67,0,2603,36,2020-07-18,21757
"Lonoke",246,5838,184,2,6084,60,2020-07-18,72206
"Madison",227,2084,212,1,2311,14,2020-07-18,16078
"Marion",15,1083,12,0,1098,3,2020-07-18,16438
"Miller",329,2868,195,2,3197,132,2020-07-18,43759
"Mississippi",401,4666,280,5,5067,116,2020-07-18,42831
"Monroe",29,945,22,0,974,7,2020-07-18,7249
"Montgomery",12,725,7,0,737,5,2020-07-18,8993
"Nevada",116,1345,85,6,1461,25,2020-07-18,8440
"Newton",14,596,8,0,610,6,2020-07-18,7848
"Ouachita",44,2194,30,1,2238,13,2020-07-18,24106
"Perry",39,1114,32,0,1153,7,2020-07-18,10322
"Phillips",205,2996,152,6,3201,47,2020-07-18,19034
"Pike",30,2154,17,0,2184,13,2020-07-18,10808
"Poinsett",90,1953,63,3,2043,24,2020-07-18,24054
"Polk",101,1759,85,0,1860,16,2020-07-18,20163
"Pope",817,6920,625,4,7737,188,2020-07-18,63644
"Prairie",44,743,27,0,787,17,2020-07-18,8244
"Pulaski",3578,46501,2591,69,50079,918,2020-07-18,393463
"Randolph",94,2249,64,2,2343,28,2020-07-18,17603
"Saline",578,11301,433,3,11879,142,2020-07-18,118009
"Scott",19,712,14,0,731,5,2020-07-18,10442
"Searcy",18,913,15,0,931,3,2020-07-18,7923
"Sebastian",1102,14923,715,9,16025,378,2020-07-18,127461
"Sevier",846,3849,776,9,4695,61,2020-07-18,17193
"Sharp",79,1303,53,5,1382,21,2020-07-18,17043
"St. Francis",942,4724,892,3,5666,47,2020-07-18,26294
"Stone",27,1389,19,1,1416,7,2020-07-18,12446
"Union",305,3482,244,14,3787,47,2020-07-18,39732
"Van Buren",38,1269,34,2,1307,2,2020-07-18,16684
"Washington",5059,18012,4323,37,23071,699,2020-07-18,228529
"White",168,4844,122,2,5012,44,2020-07-18,78804
"Woodruff",17,858,11,0,875,6,2020-07-18,6660
"Yell",909,2807,713,12,3716,184,2020-07-18,21757
"Arkansas",107,1863,46,0,1970,61,2020-07-17,18124
"Ashley",119,1871,88,3,1990,28,2020-07-17,20537
"Baxter",35,2723,29,0,2758,6,2020-07-17,41219
"Benton",3699,41443,3215,24,45142,460,2020-07-17,258980
"Boone",71,2979,41,1,3050,29,2020-07-17,37288
"Bradley",88,1365,60,2,1453,26,2020-07-17,10948
"Calhoun",5,423,3,0,428,2,2020-07-17,5202
"Carroll",253,3276,201,6,3529,46,2020-07-17,27887
"Chicot",248,1678,163,3,1926,82,2020-07-17,10826
"Clark",88,2185,69,0,2273,19,2020-07-17,22385
"Clay",87,1821,69,3,1908,15,2020-07-17,15061
"Cleburne",149,2586,117,5,2735,27,2020-07-17,25230
"Cleveland",41,889,33,0,930,8,2020-07-17,8226
"Columbia",124,1793,87,5,1917,32,2020-07-17,23892
"Conway",107,2116,81,3,2223,23,2020-07-17,20906
"Craighead",682,12737,528,7,13419,147,2020-07-17,105701
"Crawford",327,5740,228,3,6067,96,2020-07-17,62472
"Crittenden",916,6611,797,14,7527,105,2020-07-17,49013
"Cross",110,1650,87,1,1760,22,2020-07-17,16998
"Dallas",20,634,11,0,654,9,2020-07-17,7432
"Desha",90,1302,64,1,1392,25,2020-07-17,11887
"Drew",102,2088,74,2,2190,26,2020-07-17,18502
"Faulkner",869,12625,644,4,13494,221,2020-07-17,122416
"Franklin",35,1746,30,1,1781,4,2020-07-17,17780
"Fulton",19,1065,16,0,1084,3,2020-07-17,12139
"Garland",423,9444,309,5,9867,109,2020-07-17,98298
"Grant",74,1588,52,0,1662,22,2020-07-17,18086
"Greene",162,4646,137,0,4808,25,2020-07-17,44623
"Hempstead",108,2031,71,1,2139,36,2020-07-17,22018
"Hot Spring",1339,4259,592,2,5598,745,2020-07-17,33520
"Howard",161,1770,121,1,1931,39,2020-07-17,13389
"Independence",97,3443,65,0,3540,32,2020-07-17,37264
"Izard",28,1126,22,1,1154,5,2020-07-17,13559
"Jackson",43,1484,34,0,1527,9,2020-07-17,17225
"Jefferson",950,9375,735,30,10325,185,2020-07-17,70424
"Johnson",471,1793,361,0,2264,110,2020-07-17,26291
"Lafayette",34,428,22,2,462,10,2020-07-17,6915
"Lawrence",129,1848,94,9,1977,26,2020-07-17,16669
"Lee",855,2447,784,6,3302,65,2020-07-17,9398
"Lincoln",1115,2113,1019,11,3228,85,2020-07-17,13695
"Little River",58,943,45,1,1001,12,2020-07-17,12417
"Logan",100,2461,64,0,2561,36,2020-07-17,21757
"Lonoke",240,5780,181,2,6020,57,2020-07-17,72206
"Madison",226,2054,210,1,2280,15,2020-07-17,16078
"Marion",14,1073,12,0,1087,2,2020-07-17,16438
"Miller",324,2840,152,2,3164,170,2020-07-17,43759
"Mississippi",381,4574,270,4,4955,107,2020-07-17,42831
"Monroe",29,936,22,0,965,7,2020-07-17,7249
"Montgomery",12,721,7,0,733,5,2020-07-17,8993
"Nevada",116,1332,86,6,1448,24,2020-07-17,8440
"Newton",13,591,8,0,604,5,2020-07-17,7848
"Ouachita",41,2175,30,1,2216,10,2020-07-17,24106
"Perry",38,1097,31,0,1135,7,2020-07-17,10322
"Phillips",193,2870,150,6,3063,37,2020-07-17,19034
"Pike",27,2130,15,0,2157,12,2020-07-17,10808
"Poinsett",83,1932,63,3,2015,17,2020-07-17,24054
"Polk",98,1752,84,0,1850,14,2020-07-17,20163
"Pope",801,6864,618,4,7665,179,2020-07-17,63644
"Prairie",40,734,26,0,774,14,2020-07-17,8244
"Pulaski",3497,45834,2512,69,49331,916,2020-07-17,393463
"Randolph",92,2234,61,2,2326,29,2020-07-17,17603
"Saline",565,11203,414,3,11768,148,2020-07-17,118009
"Scott",18,698,14,0,716,4,2020-07-17,10442
"Searcy",18,908,14,0,926,4,2020-07-17,7923
"Sebastian",1048,14601,684,9,15649,355,2020-07-17,127461
"Sevier",842,3826,772,9,4668,61,2020-07-17,17193
"Sharp",77,1288,53,5,1365,19,2020-07-17,17043
"St. Francis",938,4688,890,3,5626,45,2020-07-17,26294
"Stone",24,1375,19,1,1399,4,2020-07-17,12446
"Union",292,3454,242,14,3746,36,2020-07-17,39732
"Van Buren",37,1254,34,2,1291,1,2020-07-17,16684
"Washington",4913,17606,4239,37,22519,637,2020-07-17,228529
"White",167,4816,116,2,4983,49,2020-07-17,78804
"Woodruff",16,856,10,0,872,6,2020-07-17,6660
"Yell",905,2778,705,11,3683,189,2020-07-17,21757
"Arkansas",98,1799,41,0,1897,57,2020-07-16,18124
"Ashley",117,1849,86,3,1966,28,2020-07-16,20537
"Baxter",34,2677,29,0,2711,5,2020-07-16,41219
"Benton",3661,40946,3165,23,44607,473,2020-07-16,258980
"Boone",70,2972,39,1,3042,30,2020-07-16,37288
"Bradley",87,1325,57,2,1412,28,2020-07-16,10948
"Calhoun",5,414,3,0,419,2,2020-07-16,5202
"Carroll",251,3250,196,6,3501,49,2020-07-16,27887
"Chicot",245,1668,160,3,1913,82,2020-07-16,10826
"Clark",83,2109,67,0,2192,16,2020-07-16,22385
"Clay",86,1812,67,3,1898,16,2020-07-16,15061
"Cleburne",148,2505,113,4,2653,31,2020-07-16,25230
"Cleveland",40,882,32,0,922,8,2020-07-16,8226
"Columbia",119,1706,87,5,1825,27,2020-07-16,23892
"Conway",104,2023,74,3,2127,27,2020-07-16,20906
"Craighead",650,12630,517,7,13280,126,2020-07-16,105701
"Crawford",310,5609,221,3,5919,86,2020-07-16,62472
"Crittenden",906,6579,788,14,7485,104,2020-07-16,49013
"Cross",107,1633,86,1,1740,20,2020-07-16,16998
"Dallas",20,616,11,0,636,9,2020-07-16,7432
"Desha",89,1285,59,1,1374,29,2020-07-16,11887
"Drew",102,2076,72,2,2178,28,2020-07-16,18502
"Faulkner",857,12453,619,4,13310,234,2020-07-16,122416
"Franklin",35,1706,29,1,1741,5,2020-07-16,17780
"Fulton",18,1061,16,0,1079,2,2020-07-16,12139
"Garland",394,9265,296,5,9659,93,2020-07-16,98298
"Grant",69,1538,51,0,1607,18,2020-07-16,18086
"Greene",158,4610,135,0,4768,23,2020-07-16,44623
"Hempstead",101,1986,68,1,2087,32,2020-07-16,22018
"Hot Spring",1310,4134,589,2,5444,719,2020-07-16,33520
"Howard",158,1751,121,1,1909,36,2020-07-16,13389
"Independence",93,3425,63,0,3518,30,2020-07-16,37264
"Izard",26,1111,22,1,1137,3,2020-07-16,13559
"Jackson",43,1460,34,0,1503,9,2020-07-16,17225
"Jefferson",937,9275,723,29,10212,185,2020-07-16,70424
"Johnson",455,1730,345,0,2185,110,2020-07-16,26291
"Lafayette",32,414,22,2,446,8,2020-07-16,6915
"Lawrence",123,1827,92,9,1950,22,2020-07-16,16669
"Lee",854,2420,750,5,3274,99,2020-07-16,9398
"Lincoln",1105,2088,1017,11,3193,77,2020-07-16,13695
"Little River",55,935,43,1,990,11,2020-07-16,12417
"Logan",97,2425,62,0,2522,35,2020-07-16,21757
"Lonoke",234,5674,177,2,5908,55,2020-07-16,72206
"Madison",226,2042,206,1,2268,19,2020-07-16,16078
"Marion",14,1065,11,0,1079,3,2020-07-16,16438
"Miller",304,2785,148,2,3089,154,2020-07-16,43759
"Mississippi",375,4531,260,4,4906,111,2020-07-16,42831
"Monroe",29,901,19,0,930,10,2020-07-16,7249
"Montgomery",12,711,7,0,723,5,2020-07-16,8993
"Nevada",114,1301,87,3,1415,24,2020-07-16,8440
"Newton",13,583,8,0,596,5,2020-07-16,7848
"Ouachita",38,2137,27,0,2175,11,2020-07-16,24106
"Perry",37,1085,31,0,1122,6,2020-07-16,10322
"Phillips",193,2853,150,6,3046,37,2020-07-16,19034
"Pike",27,2088,15,0,2115,12,2020-07-16,10808
"Poinsett",82,1912,60,3,1994,19,2020-07-16,24054
"Polk",98,1732,82,0,1830,16,2020-07-16,20163
"Pope",769,6756,598,4,7525,167,2020-07-16,63644
"Prairie",39,718,25,0,757,14,2020-07-16,8244
"Pulaski",3425,45020,2451,67,48445,907,2020-07-16,393463
"Randolph",87,2198,54,2,2285,31,2020-07-16,17603
"Saline",540,10993,398,3,11533,139,2020-07-16,118009
"Scott",18,671,13,0,689,5,2020-07-16,10442
"Searcy",18,906,14,0,924,4,2020-07-16,7923
"Sebastian",1025,14317,663,8,15342,354,2020-07-16,127461
"Sevier",829,3782,768,9,4611,52,2020-07-16,17193
"Sharp",75,1274,53,5,1349,17,2020-07-16,17043
"St. Francis",931,4650,886,3,5581,42,2020-07-16,26294
"Stone",24,1362,18,1,1386,5,2020-07-16,12446
"Union",287,3405,239,14,3692,34,2020-07-16,39732
"Van Buren",37,1229,34,2,1266,1,2020-07-16,16684
"Washington",4860,17248,4141,37,22108,682,2020-07-16,228529
"White",165,4741,113,2,4906,50,2020-07-16,78804
"Woodruff",16,833,9,0,849,7,2020-07-16,6660
"Yell",901,2741,696,10,3642,195,2020-07-16,21757
"Arkansas",73,1736,36,0,1809,37,2020-07-15,18124
"Ashley",114,1800,82,3,1914,29,2020-07-15,20537
"Baxter",34,2648,28,0,2682,6,2020-07-15,41219
"Benton",3598,40539,3108,23,44137,467,2020-07-15,258980
"Boone",66,2933,33,1,2999,32,2020-07-15,37288
"Bradley",85,1312,54,2,1397,29,2020-07-15,10948
"Calhoun",4,405,2,0,409,2,2020-07-15,5202
"Carroll",239,3234,188,6,3473,45,2020-07-15,27887
"Chicot",229,1627,159,3,1856,67,2020-07-15,10826
"Clark",80,2062,65,0,2142,15,2020-07-15,22385
"Clay",84,1776,65,3,1860,16,2020-07-15,15061
"Cleburne",138,2425,107,4,2563,27,2020-07-15,25230
"Cleveland",39,857,30,0,896,9,2020-07-15,8226
"Columbia",114,1681,86,5,1795,23,2020-07-15,23892
"Conway",103,1958,71,3,2061,29,2020-07-15,20906
"Craighead",626,12417,504,7,13043,115,2020-07-15,105701
"Crawford",296,5518,211,3,5814,82,2020-07-15,62472
"Crittenden",893,6525,773,14,7418,106,2020-07-15,49013
"Cross",103,1604,86,1,1707,16,2020-07-15,16998
"Dallas",14,597,11,0,611,3,2020-07-15,7432
"Desha",86,1240,57,1,1326,28,2020-07-15,11887
"Drew",98,2016,70,2,2114,26,2020-07-15,18502
"Faulkner",830,12252,600,4,13082,226,2020-07-15,122416
"Franklin",34,1689,26,1,1723,7,2020-07-15,17780
"Fulton",18,1051,16,0,1069,2,2020-07-15,12139
"Garland",366,8996,292,5,9362,69,2020-07-15,98298
"Grant",64,1495,50,0,1559,14,2020-07-15,18086
"Greene",156,4542,133,0,4698,23,2020-07-15,44623
"Hempstead",96,1968,61,1,2064,34,2020-07-15,22018
"Hot Spring",1300,4098,508,1,5398,791,2020-07-15,33520
"Howard",157,1733,118,1,1890,38,2020-07-15,13389
"Independence",83,3379,62,0,3462,21,2020-07-15,37264
"Izard",26,1099,22,1,1125,3,2020-07-15,13559
"Jackson",43,1437,31,0,1480,12,2020-07-15,17225
"Jefferson",917,8745,709,29,9662,179,2020-07-15,70424
"Johnson",444,1721,334,0,2165,110,2020-07-15,26291
"Lafayette",32,408,21,2,440,9,2020-07-15,6915
"Lawrence",121,1817,91,9,1938,21,2020-07-15,16669
"Lee",851,2409,745,5,3260,101,2020-07-15,9398
"Lincoln",1052,2008,1016,11,3060,25,2020-07-15,13695
"Little River",54,930,41,0,984,13,2020-07-15,12417
"Logan",91,2385,54,0,2476,37,2020-07-15,21757
"Lonoke",218,5560,166,2,5778,50,2020-07-15,72206
"Madison",223,2035,205,1,2258,17,2020-07-15,16078
"Marion",14,1056,11,0,1070,3,2020-07-15,16438
"Miller",293,2745,144,2,3038,147,2020-07-15,43759
"Mississippi",357,4473,244,3,4830,110,2020-07-15,42831
"Monroe",26,882,19,0,908,7,2020-07-15,7249
"Montgomery",8,704,6,0,712,2,2020-07-15,8993
"Nevada",112,1288,87,3,1400,22,2020-07-15,8440
"Newton",13,577,7,0,590,6,2020-07-15,7848
"Ouachita",37,2116,27,0,2153,10,2020-07-15,24106
"Perry",36,1063,31,0,1099,5,2020-07-15,10322
"Phillips",192,2836,144,5,3028,43,2020-07-15,19034
"Pike",23,2059,11,0,2082,12,2020-07-15,10808
"Poinsett",79,1887,58,3,1966,18,2020-07-15,24054
"Polk",94,1714,80,0,1808,14,2020-07-15,20163
"Pope",729,6701,581,4,7430,144,2020-07-15,63644
"Prairie",39,702,22,0,741,17,2020-07-15,8244
"Pulaski",3298,44005,2344,67,47303,887,2020-07-15,393463
"Randolph",83,2165,51,2,2248,30,2020-07-15,17603
"Saline",521,10794,380,3,11315,138,2020-07-15,118009
"Scott",18,661,14,0,679,4,2020-07-15,10442
"Searcy",17,900,12,0,917,5,2020-07-15,7923
"Sebastian",981,14073,622,8,15054,351,2020-07-15,127461
"Sevier",822,3769,751,9,4591,62,2020-07-15,17193
"Sharp",72,1255,53,5,1327,14,2020-07-15,17043
"St. Francis",926,4625,879,3,5551,44,2020-07-15,26294
"Stone",23,1351,16,1,1374,6,2020-07-15,12446
"Union",284,3357,238,14,3641,32,2020-07-15,39732
"Van Buren",37,1214,34,2,1251,1,2020-07-15,16684
"Washington",4778,17050,4061,37,21828,680,2020-07-15,228529
"White",157,4612,106,2,4769,49,2020-07-15,78804
"Woodruff",14,799,8,0,813,6,2020-07-15,6660
"Yell",873,2674,683,8,3547,182,2020-07-15,21757
"Arkansas",66,1729,32,0,1795,34,2020-07-14,18124
"Ashley",111,1785,77,3,1896,31,2020-07-14,20537
"Baxter",31,2641,24,0,2672,7,2020-07-14,41219
"Benton",3551,40010,3055,23,43561,473,2020-07-14,258980
"Boone",63,2869,33,1,2932,29,2020-07-14,37288
"Bradley",82,1303,54,2,1385,26,2020-07-14,10948
"Calhoun",4,403,2,0,407,2,2020-07-14,5202
"Carroll",236,3201,182,6,3437,48,2020-07-14,27887
"Chicot",224,1604,157,3,1828,64,2020-07-14,10826
"Clark",76,2054,64,0,2130,12,2020-07-14,22385
"Clay",84,1762,65,3,1846,16,2020-07-14,15061
"Cleburne",137,2407,104,4,2544,29,2020-07-14,25230
"Cleveland",38,851,29,0,889,9,2020-07-14,8226
"Columbia",112,1658,84,5,1770,23,2020-07-14,23892
"Conway",98,1929,66,3,2027,29,2020-07-14,20906
"Craighead",610,12292,487,7,12902,116,2020-07-14,105701
"Crawford",291,5413,198,3,5704,90,2020-07-14,62472
"Crittenden",879,6501,764,14,7380,101,2020-07-14,49013
"Cross",102,1595,85,1,1697,16,2020-07-14,16998
"Dallas",13,595,10,0,608,3,2020-07-14,7432
"Desha",85,1215,55,1,1300,29,2020-07-14,11887
"Drew",96,1969,70,2,2065,24,2020-07-14,18502
"Faulkner",810,12093,570,4,12903,236,2020-07-14,122416
"Franklin",34,1653,24,1,1687,9,2020-07-14,17780
"Fulton",18,1045,16,0,1063,2,2020-07-14,12139
"Garland",347,8893,273,3,9240,71,2020-07-14,98298
"Grant",62,1484,46,0,1546,16,2020-07-14,18086
"Greene",154,4471,130,0,4625,24,2020-07-14,44623
"Hempstead",96,1956,60,1,2052,35,2020-07-14,22018
"Hot Spring",1294,4072,443,1,5366,850,2020-07-14,33520
"Howard",154,1731,115,1,1885,38,2020-07-14,13389
"Independence",79,3349,61,0,3428,18,2020-07-14,37264
"Izard",26,1096,22,1,1122,3,2020-07-14,13559
"Jackson",42,1416,28,0,1458,14,2020-07-14,17225
"Jefferson",900,8662,698,29,9562,173,2020-07-14,70424
"Johnson",427,1719,311,0,2146,116,2020-07-14,26291
"Lafayette",32,406,19,2,438,11,2020-07-14,6915
"Lawrence",123,1810,91,9,1933,23,2020-07-14,16669
"Lee",850,2402,742,5,3252,103,2020-07-14,9398
"Lincoln",1052,1993,1016,11,3045,25,2020-07-14,13695
"Little River",50,928,41,0,978,9,2020-07-14,12417
"Logan",89,2352,53,0,2441,36,2020-07-14,21757
"Lonoke",213,5513,159,1,5726,53,2020-07-14,72206
"Madison",224,2026,199,1,2250,24,2020-07-14,16078
"Marion",14,1051,11,0,1065,3,2020-07-14,16438
"Miller",291,2720,139,2,3011,150,2020-07-14,43759
"Mississippi",349,4428,230,3,4777,116,2020-07-14,42831
"Monroe",27,874,16,0,901,11,2020-07-14,7249
"Montgomery",7,696,6,0,703,1,2020-07-14,8993
"Nevada",112,1286,86,3,1398,23,2020-07-14,8440
"Newton",12,567,7,0,579,5,2020-07-14,7848
"Ouachita",37,2105,27,0,2142,10,2020-07-14,24106
"Perry",34,948,30,0,982,4,2020-07-14,10322
"Phillips",191,2830,142,5,3021,44,2020-07-14,19034
"Pike",20,2044,10,0,2064,10,2020-07-14,10808
"Poinsett",78,1879,55,3,1957,20,2020-07-14,24054
"Polk",90,1698,78,0,1788,12,2020-07-14,20163
"Pope",719,6635,560,4,7354,155,2020-07-14,63644
"Prairie",38,693,22,0,731,16,2020-07-14,8244
"Pulaski",3148,43481,2254,67,46629,827,2020-07-14,393463
"Randolph",80,2153,51,2,2233,27,2020-07-14,17603
"Saline",512,10685,359,3,11197,150,2020-07-14,118009
"Scott",17,647,12,0,664,5,2020-07-14,10442
"Searcy",17,895,11,0,912,6,2020-07-14,7923
"Sebastian",929,13762,588,8,14691,333,2020-07-14,127461
"Sevier",819,3757,735,9,4576,75,2020-07-14,17193
"Sharp",69,1249,51,5,1318,13,2020-07-14,17043
"St. Francis",920,4602,878,3,5522,39,2020-07-14,26294
"Stone",22,1346,15,1,1368,6,2020-07-14,12446
"Union",282,3343,230,14,3625,38,2020-07-14,39732
"Van Buren",37,1209,34,2,1246,1,2020-07-14,16684
"Washington",4721,16252,3956,37,20973,728,2020-07-14,228529
"White",156,4582,103,2,4738,51,2020-07-14,78804
"Woodruff",14,792,7,0,806,7,2020-07-14,6660
"Yell",863,2513,668,7,3376,188,2020-07-14,21757
"Arkansas",60,1708,31,0,1768,29,2020-07-13,18124
"Ashley",110,1774,74,3,1884,33,2020-07-13,20537
"Baxter",31,2602,23,0,2633,8,2020-07-13,41219
"Benton",3496,39651,2974,22,43147,500,2020-07-13,258980
"Boone",53,2824,29,1,2877,23,2020-07-13,37288
"Bradley",81,1301,53,2,1382,26,2020-07-13,10948
"Calhoun",3,399,2,0,402,1,2020-07-13,5202
"Carroll",230,3157,179,6,3387,45,2020-07-13,27887
"Chicot",218,1596,150,3,1814,65,2020-07-13,10826
"Clark",73,2041,60,0,2114,13,2020-07-13,22385
"Clay",82,1747,65,3,1829,14,2020-07-13,15061
"Cleburne",133,2383,99,4,2516,30,2020-07-13,25230
"Cleveland",38,849,27,0,887,11,2020-07-13,8226
"Columbia",109,1646,83,5,1755,21,2020-07-13,23892
"Conway",97,1884,59,3,1981,35,2020-07-13,20906
"Craighead",565,12154,475,7,12719,83,2020-07-13,105701
"Crawford",284,5338,182,3,5622,99,2020-07-13,62472
"Crittenden",865,6471,756,14,7336,95,2020-07-13,49013
"Cross",101,1589,85,1,1690,15,2020-07-13,16998
"Dallas",12,588,10,0,600,2,2020-07-13,7432
"Desha",84,1194,53,1,1278,30,2020-07-13,11887
"Drew",95,1951,67,2,2046,26,2020-07-13,18502
"Faulkner",788,11897,545,3,12685,240,2020-07-13,122416
"Franklin",33,1629,24,1,1662,8,2020-07-13,17780
"Fulton",18,1037,15,0,1055,3,2020-07-13,12139
"Garland",341,8818,268,3,9159,70,2020-07-13,98298
"Grant",58,1452,44,0,1510,14,2020-07-13,18086
"Greene",150,4435,127,0,4585,23,2020-07-13,44623
"Hempstead",87,1880,58,1,1967,28,2020-07-13,22018
"Hot Spring",1270,4051,441,1,5321,828,2020-07-13,33520
"Howard",138,1674,108,1,1812,29,2020-07-13,13389
"Independence",74,3314,59,0,3388,15,2020-07-13,37264
"Izard",25,1076,21,1,1101,3,2020-07-13,13559
"Jackson",41,1391,28,0,1432,13,2020-07-13,17225
"Jefferson",884,8396,683,29,9280,172,2020-07-13,70424
"Johnson",381,1716,293,0,2097,88,2020-07-13,26291
"Lafayette",30,404,19,2,434,9,2020-07-13,6915
"Lawrence",115,1786,90,9,1901,16,2020-07-13,16669
"Lee",828,2393,655,4,3221,169,2020-07-13,9398
"Lincoln",1048,1982,1015,11,3030,22,2020-07-13,13695
"Little River",45,921,40,0,966,5,2020-07-13,12417
"Logan",87,2332,51,0,2419,36,2020-07-13,21757
"Lonoke",201,5441,152,1,5642,48,2020-07-13,72206
"Madison",223,2012,198,1,2235,24,2020-07-13,16078
"Marion",14,1038,10,0,1052,4,2020-07-13,16438
"Miller",280,2685,132,2,2965,146,2020-07-13,43759
"Mississippi",337,4378,212,3,4715,122,2020-07-13,42831
"Monroe",22,850,16,0,872,6,2020-07-13,7249
"Montgomery",7,694,6,0,701,1,2020-07-13,8993
"Nevada",110,1263,86,3,1373,21,2020-07-13,8440
"Newton",11,558,7,0,569,4,2020-07-13,7848
"Ouachita",36,2084,26,0,2120,10,2020-07-13,24106
"Perry",34,930,29,0,964,5,2020-07-13,10322
"Phillips",175,2759,136,5,2934,34,2020-07-13,19034
"Pike",20,2020,9,0,2040,11,2020-07-13,10808
"Poinsett",76,1866,55,3,1942,18,2020-07-13,24054
"Polk",89,1683,78,0,1772,11,2020-07-13,20163
"Pope",679,6570,532,4,7249,143,2020-07-13,63644
"Prairie",30,675,21,0,705,9,2020-07-13,8244
"Pulaski",3019,42583,2143,65,45602,811,2020-07-13,393463
"Randolph",78,2145,49,2,2223,27,2020-07-13,17603
"Saline",490,10552,342,3,11042,145,2020-07-13,118009
"Scott",17,641,12,0,658,5,2020-07-13,10442
"Searcy",18,892,11,0,910,7,2020-07-13,7923
"Sebastian",874,13343,541,7,14217,326,2020-07-13,127461
"Sevier",811,3725,720,9,4536,82,2020-07-13,17193
"Sharp",69,1245,51,5,1314,13,2020-07-13,17043
"St. Francis",911,4587,875,3,5498,33,2020-07-13,26294
"Stone",22,1336,14,1,1358,7,2020-07-13,12446
"Union",275,3321,228,14,3596,33,2020-07-13,39732
"Van Buren",36,1200,32,2,1236,2,2020-07-13,16684
"Washington",4594,15942,3825,37,20536,732,2020-07-13,228529
"White",149,4544,99,2,4693,48,2020-07-13,78804
"Woodruff",12,788,7,0,800,5,2020-07-13,6660
"Yell",838,2495,654,5,3333,179,2020-07-13,21757
"Arkansas",59,1694,30,0,1753,29,2020-07-12,18124
"Ashley",100,1732,71,3,1832,26,2020-07-12,20537
"Baxter",30,2573,22,0,2603,8,2020-07-12,41219
"Benton",3470,39078,2923,22,42548,525,2020-07-12,258980
"Boone",51,2741,28,1,2792,22,2020-07-12,37288
"Bradley",80,1285,52,2,1365,26,2020-07-12,10948
"Calhoun",3,376,2,0,379,1,2020-07-12,5202
"Carroll",228,3140,176,6,3368,46,2020-07-12,27887
"Chicot",217,1585,143,3,1802,71,2020-07-12,10826
"Clark",71,2030,58,0,2101,13,2020-07-12,22385
"Clay",81,1729,62,3,1810,16,2020-07-12,15061
"Cleburne",132,2342,97,4,2474,31,2020-07-12,25230
"Cleveland",37,841,27,0,878,10,2020-07-12,8226
"Columbia",109,1622,81,5,1731,23,2020-07-12,23892
"Conway",92,1851,55,3,1943,34,2020-07-12,20906
"Craighead",545,11971,466,7,12516,72,2020-07-12,105701
"Crawford",275,5198,177,3,5473,95,2020-07-12,62472
"Crittenden",841,6421,746,14,7262,81,2020-07-12,49013
"Cross",101,1580,85,1,1681,15,2020-07-12,16998
"Dallas",12,584,10,0,596,2,2020-07-12,7432
"Desha",81,1186,52,1,1267,28,2020-07-12,11887
"Drew",92,1916,66,2,2008,24,2020-07-12,18502
"Faulkner",771,11718,521,3,12489,247,2020-07-12,122416
"Franklin",30,1594,22,1,1624,7,2020-07-12,17780
"Fulton",18,1024,13,0,1042,5,2020-07-12,12139
"Garland",332,8733,264,3,9065,65,2020-07-12,98298
"Grant",55,1411,44,0,1466,11,2020-07-12,18086
"Greene",148,4374,125,0,4522,23,2020-07-12,44623
"Hempstead",79,1851,57,1,1930,21,2020-07-12,22018
"Hot Spring",1266,4020,439,1,5286,826,2020-07-12,33520
"Howard",137,1636,106,1,1773,30,2020-07-12,13389
"Independence",73,3265,59,0,3338,14,2020-07-12,37264
"Izard",25,1066,21,1,1091,3,2020-07-12,13559
"Jackson",41,1363,28,0,1404,13,2020-07-12,17225
"Jefferson",861,7900,676,29,8761,156,2020-07-12,70424
"Johnson",366,1656,286,0,2022,80,2020-07-12,26291
"Lafayette",29,392,17,2,421,10,2020-07-12,6915
"Lawrence",115,1755,90,9,1870,16,2020-07-12,16669
"Lee",827,2333,642,4,3160,181,2020-07-12,9398
"Lincoln",1048,1972,1015,11,3020,22,2020-07-12,13695
"Little River",43,904,40,0,947,3,2020-07-12,12417
"Logan",81,2261,49,0,2342,32,2020-07-12,21757
"Lonoke",197,5303,146,1,5500,50,2020-07-12,72206
"Madison",223,1996,197,1,2219,25,2020-07-12,16078
"Marion",13,1033,10,0,1046,3,2020-07-12,16438
"Miller",265,2611,128,2,2876,135,2020-07-12,43759
"Mississippi",314,4323,185,3,4637,126,2020-07-12,42831
"Monroe",21,839,15,0,860,6,2020-07-12,7249
"Montgomery",7,686,6,0,693,1,2020-07-12,8993
"Nevada",109,1250,87,3,1359,19,2020-07-12,8440
"Newton",10,552,7,0,562,3,2020-07-12,7848
"Ouachita",34,2045,24,0,2079,10,2020-07-12,24106
"Perry",34,923,29,0,957,5,2020-07-12,10322
"Phillips",173,2721,133,5,2894,35,2020-07-12,19034
"Pike",19,1974,9,0,1993,10,2020-07-12,10808
"Poinsett",75,1808,54,3,1883,18,2020-07-12,24054
"Polk",88,1645,77,0,1733,11,2020-07-12,20163
"Pope",655,6442,507,4,7097,144,2020-07-12,63644
"Prairie",30,663,21,0,693,9,2020-07-12,8244
"Pulaski",2938,41204,2054,65,44142,819,2020-07-12,393463
"Randolph",76,2124,49,1,2200,26,2020-07-12,17603
"Saline",471,10338,329,3,10809,139,2020-07-12,118009
"Scott",16,598,12,0,614,4,2020-07-12,10442
"Searcy",17,880,11,0,897,6,2020-07-12,7923
"Sebastian",834,12852,518,7,13686,309,2020-07-12,127461
"Sevier",807,3695,710,9,4502,88,2020-07-12,17193
"Sharp",68,1236,51,5,1304,12,2020-07-12,17043
"St. Francis",906,4548,874,3,5454,29,2020-07-12,26294
"Stone",22,1314,14,1,1336,7,2020-07-12,12446
"Union",274,3288,226,14,3562,34,2020-07-12,39732
"Van Buren",35,1191,31,2,1226,2,2020-07-12,16684
"Washington",4526,15619,3756,36,20145,734,2020-07-12,228529
"White",141,4473,96,2,4614,43,2020-07-12,78804
"Woodruff",12,771,7,0,783,5,2020-07-12,6660
"Yell",832,2484,631,5,3316,196,2020-07-12,21757
